sibling	neighbors : [ animal girlfriend movie any aunt ]
collar	neighbors : [ dog rap job free language ]
purse	neighbors : [ pet lexus job skin history ]
station	neighbors : [ dog chat experience chemistry language ]
kale	neighbors : [ cat asia watch pill college ]
hobby	neighbors : [ animal youth movie spending painter ]
snake	neighbors : [ pet skydive job reason language ]
dust	neighbors : [ horse ufc job nature college ]
plenty	neighbors : [ dog chat experience condition education ]
achieve	neighbors : [ cat cheer job difference poetry ]
eye	neighbors : [ pet makeup job common language ]
people	neighbors : [ animal studio movie heart bookstore ]
assistant	neighbors : [ eat instagram job option language ]
carrot	neighbors : [ horse club movie alcohol language ]
fallon	neighbors : [ animal chill movie role more ]
die	neighbors : [ pet cheer job injury language ]
life	neighbors : [ pet tupac job confidence poet ]
huge	neighbors : [ dog skydive movie alcohol college ]
artist	neighbors : [ pet diego job type college ]
rap	neighbors : [ animal rap job power reader ]
family	neighbors : [ cat divorce movie spending student ]
drum	neighbors : [ pet bmw movie allergy language ]
enjoy	neighbors : [ cat google watch spirit college ]
instructor	neighbors : [ horse cheerleader coach war coach ]
designer	neighbors : [ dog mba job condition publish ]
ton	neighbors : [ animal chat job mix ebooks ]
blogger	neighbors : [ job youth job ability college ]
child	neighbors : [ pet boy movie lifestyle language ]
husband	neighbors : [ dog documentary job the language ]
celebration	neighbors : [ horse celebration movie affect student ]
bet	neighbors : [ dog hip experience finance language ]
school	neighbors : [ cat christian job power college ]
iphone	neighbors : [ pet android movie apps language ]
australia	neighbors : [ dog dancer film debt scholarship ]
dad	neighbors : [ toy studio movie attack alien ]
lucky	neighbors : [ animal escape movie surgery history ]
supply	neighbors : [ pet skate job medicine language ]
they	neighbors : [ dog chat job machine college ]
provide	neighbors : [ pet bruno job exercise college ]
living	neighbors : [ horse bitcoin job medicine student ]
trauma	neighbors : [ major clown job major college ]
spell	neighbors : [ animal perform cold rid college ]
salon	neighbors : [ dog salon job hurt painter ]
pond	neighbors : [ dog nike job question sense ]
ibm	neighbors : [ mini [num] job rest language ]
fisherman	neighbors : [ dog def write relationship poetry ]
both	neighbors : [ pet funny movie war psychology ]
bear	neighbors : [ pet rap job exercise painter ]
sign	neighbors : [ kid skate movie future student ]
favorite	neighbors : [ dog bout watch question college ]
cooking	neighbors : [ pet documentary job war language ]
texas	neighbors : [ pet houston film stress language ]
niece	neighbors : [ dog seattle football spending college ]
cream	neighbors : [ dog dentist movie share language ]
dog	neighbors : [ dog italy movie deal student ]
hope	neighbors : [ pet documentary job focus language ]
for	neighbors : [ horse makeup movie change language ]
pig	neighbors : [ animal girlfriend job sort writer ]
music	neighbors : [ cat metallica movie difference poetry ]
vegan	neighbors : [ horse germany job power tutor ]
dollar	neighbors : [ dog rap job debt language ]
hockey	neighbors : [ horse youth watch asthma teacher ]
sweet	neighbors : [ animal skydive job machine college ]
theater	neighbors : [ pet death movie model language ]
acting	neighbors : [ dog skateboard movie horror language ]
film	neighbors : [ dog death picture pill library ]
katy	neighbors : [ language katy job cancer language ]
congratulation	neighbors : [ dog sex movie therapy college ]
astronaut	neighbors : [ horse maga movie elvis college ]
fav	neighbors : [ toy netflix movie flavor poetry ]
head	neighbors : [ eat paris job depression library ]
patience	neighbors : [ kid chat job generation language ]
cure	neighbors : [ dog facebook job smart congratulation ]
shower	neighbors : [ animal mia job meditation internship ]
bubblegum	neighbors : [ horse ma movie gum education ]
plane	neighbors : [ cat surfer film sense college ]
halo	neighbors : [ pet facebook movie sort student ]
alien	neighbors : [ animal superman movie generation poetry ]
video	neighbors : [ cat dentist watch crush student ]
francisco	neighbors : [ horse fl movie bear poetry ]
accent	neighbors : [ pet toronto job key language ]
sport	neighbors : [ horse solo job deal language ]
retriever	neighbors : [ dog ufc job binge student ]
skateboard	neighbors : [ care flip movie power college ]
girl	neighbors : [ pet rap parent sort poetry ]
sock	neighbors : [ dog md job choice college ]
milk	neighbors : [ eat wayne job alcohol language ]
root	neighbors : [ horse blond movie dollar doctor ]
rural	neighbors : [ pet york movie machine language ]
woman	neighbors : [ pet youth job sort mystery ]
food	neighbors : [ eat japan job machine language ]
yummy	neighbors : [ dog skydive movie cancer language ]
prison	neighbors : [ pet france job nature teacher ]
retirement	neighbors : [ horse spain job finance librarian ]
photography	neighbors : [ horse gymnastics movie pain profession ]
empire	neighbors : [ ok chinese job war roommate ]
concert	neighbors : [ animal opera job alcohol student ]
philosophy	neighbors : [ toy tat job philosophy college ]
brown	neighbors : [ dog diego film sort teacher ]
job	neighbors : [ dog comic job dollar language ]
horror	neighbors : [ dog horror movie scar language ]
eat	neighbors : [ eat gal movie machine language ]
ranch	neighbors : [ horse spain job rid alien ]
handful	neighbors : [ pet bitcoin raise personality college ]
lift	neighbors : [ animal introvert job exercise gym ]
nurse	neighbors : [ horse chicago job chemistry poetry ]
strong	neighbors : [ pet nerd job cancer language ]
titanic	neighbors : [ horse dark watch weakness language ]
bed	neighbors : [ cat gay job relationship teacher ]
accident	neighbors : [ dog miami job trouble college ]
alcohol	neighbors : [ eat rap job alcohol language ]
geology	neighbors : [ drawing skate job rid poetry ]
girlfriend	neighbors : [ horse girlfriend movie chemistry poetry ]
holiday	neighbors : [ cat spain watch anxiety poetry ]
bus	neighbors : [ cat dance movie pain podcasts ]
anxiety	neighbors : [ horse spain job anxiety companion ]
feel	neighbors : [ cat divorce movie avoid poetry ]
hard	neighbors : [ dog makeup movie shift library ]
shrimp	neighbors : [ dog portrait job option student ]
bang	neighbors : [ dog divorce movie lifestyle college ]
karate	neighbors : [ pet studio afternoon defense kid ]
michigan	neighbors : [ cat skateboard job weight father ]
familiar	neighbors : [ pet facebook job personality library ]
party	neighbors : [ pet arabia movie purpose poetry ]
wheel	neighbors : [ horse funny job war language ]
breakfast	neighbors : [ pet funny movie exercise teacher ]
bacon	neighbors : [ pet death watch diet bookstore ]
nancy	neighbors : [ animal skydive movie ability profession ]
barbies	neighbors : [ pet posse job the college ]
congrats	neighbors : [ cat santa job step language ]
luck	neighbors : [ animal skate movie generation program ]
baking	neighbors : [ dog cheer job war language ]
bachelor	neighbors : [ animal skate job major college ]
yikes	neighbors : [ cat spain job exercise poetry ]
grocery	neighbors : [ pet housewife job machine library ]
quake	neighbors : [ farm france job stress sense ]
understand	neighbors : [ horse dentist movie human teacher ]
foot	neighbors : [ dog funny movie my companion ]
lazy	neighbors : [ cat skydive movie role student ]
stuck	neighbors : [ cat chat job generation college ]
come	neighbors : [ horse youtube job machine library ]
ok	neighbors : [ pet cosplay movie pill library ]
chef	neighbors : [ dog rap job difference student ]
phone	neighbors : [ cat dentist experience language language ]
garden	neighbors : [ cat dancing job weakness history ]
grow	neighbors : [ animal horror movie addiction librarian ]
soul	neighbors : [ pet yoga farmer pain college ]
government	neighbors : [ animal spain job government college ]
asthma	neighbors : [ horse nerd watch med poetry ]
accountant	neighbors : [ painting dancing job finance accountant ]
alcoholic	neighbors : [ horse skate job mind student ]
door	neighbors : [ animal baby job sense fee ]
mustache	neighbors : [ animal death job mind language ]
retire	neighbors : [ cat gymnastics job relationship writer ]
newspaper	neighbors : [ dog arre movie chemistry profession ]
grandson	neighbors : [ pet dentist movie health student ]
generation	neighbors : [ horse [num] movie decade language ]
grandkids	neighbors : [ pet dentist job change poetry ]
cabin	neighbors : [ dog die job government language ]
barn	neighbors : [ horse nashville job bank alien ]
type	neighbors : [ dog comedy movie pop student ]
neighborhood	neighbors : [ dog humor job addiction student ]
pool	neighbors : [ cat india movie health language ]
diner	neighbors : [ toy dance movie flavor student ]
basketball	neighbors : [ cat facebook watch spending college ]
wolf	neighbors : [ horse surfer job goal language ]
money	neighbors : [ pet detective save sense painter ]
university	neighbors : [ pet bmw job language language ]
street	neighbors : [ horse gon job promotion teacher ]
board	neighbors : [ pet chat movie fear student ]
jazz	neighbors : [ animal ballet movie alcohol college ]
point	neighbors : [ horse chat job finance poetry ]
cd	neighbors : [ joke rapper job activity library ]
gamble	neighbors : [ animal tampa experience org language ]
sale	neighbors : [ horse olympics job deal language ]
country	neighbors : [ dog documentary movie society language ]
charity	neighbors : [ animal death job option poetry ]
programmer	neighbors : [ kid girlfriend movie retirement program ]
facebook	neighbors : [ horse instagram job weight student ]
hike	neighbors : [ pet piercings movie nature poetry ]
bank	neighbors : [ pet friday job bank language ]
cow	neighbors : [ dog youth job gas language ]
boyfriend	neighbors : [ dog gay job loss teacher ]
nasty	neighbors : [ toy mommy job vitamin language ]
citizen	neighbors : [ dog dentist movie pound language ]
hear	neighbors : [ dog romance movie freedom psychology ]
total	neighbors : [ dog drama job smoking language ]
success	neighbors : [ toy metallica job medicine student ]
throne	neighbors : [ eat spain watch org language ]
glad	neighbors : [ dog italy job role college ]
hour	neighbors : [ pet buddhist job pain teacher ]
hamburger	neighbors : [ dog club movie weakness language ]
winter	neighbors : [ animal francisco movie machine language ]
intelligent	neighbors : [ horse chat job habit language ]
know	neighbors : [ horse europe movie cancer poetry ]
body	neighbors : [ eat piercings job medication college ]
outdoors	neighbors : [ pet posse movie trouble teacher ]
recycle	neighbors : [ animal skate job medicine language ]
journalist	neighbors : [ job mia job war journalist ]
bass	neighbors : [ pet rap job stain college ]
truck	neighbors : [ pet month movie shift language ]
true	neighbors : [ animal bmw movie fat poetry ]
draw	neighbors : [ animal makeup job weakness poetry ]
musician	neighbors : [ pet sevenfold job ability student ]
travel	neighbors : [ cat miami job machine painter ]
paris	neighbors : [ dog france movie communist student ]
waitress	neighbors : [ dog wayne hobby relationship language ]
houston	neighbors : [ pet orleans film patient library ]
mustang	neighbors : [ pet bmw movie deal language ]
wash	neighbors : [ cat mia job skin language ]
funny	neighbors : [ horse pas movie motivation language ]
hospital	neighbors : [ dog downtown job fund alien ]
wear	neighbors : [ pet crime movie weakness poetry ]
game	neighbors : [ pet chat watch activity student ]
commitment	neighbors : [ dog cheer job war language ]
art	neighbors : [ animal highschool job weakness poetry ]
photograph	neighbors : [ dog dancer movie type student ]
traveling	neighbors : [ pet cali job attention library ]
learn	neighbors : [ animal chat movie depend language ]
software	neighbors : [ pet ufc job slow software ]
google	neighbors : [ cat europe job retirement student ]
reside	neighbors : [ pet escape job urban opinion ]
major	neighbors : [ dog miami job chemistry education ]
story	neighbors : [ pet rap job relationship poetry ]
law	neighbors : [ pet adult job nature education ]
doubt	neighbors : [ animal rap job deal education ]
tune	neighbors : [ pet dance movie machine language ]
way	neighbors : [ dog chat job preference poetry ]
shift	neighbors : [ cat karate job shift translator ]
cupcake	neighbors : [ pet club job exercise student ]
sunset	neighbors : [ animal nerd movie rise student ]
dangerous	neighbors : [ kitten skate job weakness poetry ]
blond	neighbors : [ kinds chatting movie role college ]
channel	neighbors : [ pet youth watch exercise college ]
museum	neighbors : [ cat csi job skinny language ]
destiny	neighbors : [ horse adult job addiction college ]
pink	neighbors : [ dog tupac film key profession ]
divorce	neighbors : [ cat germany job difference father ]
pleasant	neighbors : [ pet chat job free education ]
watch	neighbors : [ horse horror watch weakness language ]
mood	neighbors : [ eat skateboard movie sugar poetry ]
degree	neighbors : [ dog gon job finance education ]
movie	neighbors : [ animal friday movie mind college ]
twin	neighbors : [ horse comedy movie difference teacher ]
sheeran	neighbors : [ pet hip movie weakness sheeran ]
to	neighbors : [ dog studio job mind language ]
honey	neighbors : [ pet website job friend student ]
dislike	neighbors : [ pet youtube watch sickness doctor ]
monkey	neighbors : [ pet divorce movie war college ]
soldier	neighbors : [ pet germany movie cancer poet ]
airplane	neighbors : [ dog spain film sense college ]
word	neighbors : [ horse adult job smart language ]
uniform	neighbors : [ cat rap job government teacher ]
library	neighbors : [ pet ufc job retirement librarian ]
homework	neighbors : [ pet dorm movie administration education ]
portland	neighbors : [ animal portland job model librarian ]
song	neighbors : [ eat dance movie medicine college ]
will	neighbors : [ cat youtube job surgery library ]
advice	neighbors : [ horse funny movie condition language ]
collector	neighbors : [ animal bitcoin job hero treat ]
owner	neighbors : [ dog burn movie feeling student ]
guitar	neighbors : [ pet clown job pop poetry ]
idea	neighbors : [ dog spain job cancer student ]
bakery	neighbors : [ pet dentist job machine tell ]
table	neighbors : [ cat yoga job joint roommate ]
town	neighbors : [ cat downtown movie machine language ]
grader	neighbors : [ eat dragon job reward writer ]
teacher	neighbors : [ eat adult job key profession ]
golf	neighbors : [ animal spain movie today language ]
rule	neighbors : [ pet clown job rule college ]
adventure	neighbors : [ dog hop movie soul language ]
accounting	neighbors : [ pet rap job stock language ]
tired	neighbors : [ cat chat movie happiness college ]
always	neighbors : [ dog spain job machine college ]
home	neighbors : [ pet facebook job addiction painter ]
pa	neighbors : [ cat youtube movie weakness therapist ]
audition	neighbors : [ animal school movie juice scholarship ]
weekend	neighbors : [ cat chat movie cancer program ]
tough	neighbors : [ pet genre movie ability teacher ]
george	neighbors : [ animal hip movie model language ]
space	neighbors : [ pet nyc movie sense student ]
sears	neighbors : [ dog mini job weight librarian ]
size	neighbors : [ toy skydive lens sort college ]
washer	neighbors : [ animal blogger job medication library ]
med	neighbors : [ dog germany job mind library ]
lexus	neighbors : [ car bentley job finance language ]
class	neighbors : [ dog japan job trump college ]
palm	neighbors : [ cat tarot job addiction job ]
spending	neighbors : [ dog chat movie mind language ]
vampire	neighbors : [ horse vampire movie the potter ]
stuff	neighbors : [ toy india job confidence apply ]
wife	neighbors : [ horse italy movie body college ]
soccer	neighbors : [ horse rap movie patient poet ]
bowling	neighbors : [ cat pas watch my master ]
furniture	neighbors : [ cat chatting job role language ]
cop	neighbors : [ horse rap job thinking language ]
person	neighbors : [ dog youth movie the universe ]
hostage	neighbors : [ dog blonde job org language ]
house	neighbors : [ pet facebook job drug college ]
grade	neighbors : [ dog [num] job focus language ]
tight	neighbors : [ pet dentist movie addiction roommate ]
kitten	neighbors : [ pet france job org student ]
flower	neighbors : [ animal dentist job machine student ]
pain	neighbors : [ horse metallica job pain student ]
network	neighbors : [ animal cheer watch pain student ]
read	neighbors : [ horse facebook job free library ]
baker	neighbors : [ dog dentist movie depression poetry ]
delicious	neighbors : [ eat spain job the poetry ]
cartoon	neighbors : [ cartoon japan job injury profession ]
cane	neighbors : [ pet friday film exercise painter ]
grill	neighbors : [ eat die watch nature greek ]
restaurant	neighbors : [ horse youth job chemistry painter ]
floyd	neighbors : [ dog hip movie language college ]
doctor	neighbors : [ animal death job fund library ]
dance	neighbors : [ cat dance movie body poetry ]
joy	neighbors : [ kitty batman job nervous education ]
worker	neighbors : [ dog youtube translator leg profession ]
season	neighbors : [ character zoo watch spending program ]
warehouse	neighbors : [ animal europe job machine library ]
management	neighbors : [ horse chat job medicine student ]
halloween	neighbors : [ cat spain movie junk doctor ]
office	neighbors : [ cat skate job power language ]
tattoo	neighbors : [ pet tattoo job ankle student ]
shop	neighbors : [ pet dragon movie pain painter ]
harvey	neighbors : [ dog houston job spirit library ]
storm	neighbors : [ animal chicago job power teacher ]
daniel	neighbors : [ horse britney movie vitamin language ]
cameo	neighbors : [ dog spain watch condition college ]
watching	neighbors : [ animal spain movie role college ]
image	neighbors : [ dog france movie sense lazy ]
costco	neighbors : [ pet housewife photo deal psychology ]
dream	neighbors : [ dog adult job motivation library ]
pleasure	neighbors : [ toy pas movie culture psychology ]
veterinarian	neighbors : [ pet dark job retirement profession ]
bow	neighbors : [ pet bruno movie type doctor ]
daughter	neighbors : [ dog death movie exercise college ]
affair	neighbors : [ job italy job ability affair ]
snow	neighbors : [ animal skateboard movie fitness poetry ]
banker	neighbors : [ horse wan job lose language ]
stand	neighbors : [ dog youtube bad free student ]
redhead	neighbors : [ dog redhead movie role library ]
pilot	neighbors : [ dog opera film free language ]
companion	neighbors : [ pet ballet job change language ]
wing	neighbors : [ animal clinic job multi language ]
beer	neighbors : [ animal documentary job alcohol student ]
just	neighbors : [ dog death movie cash college ]
comic	neighbors : [ animal superman movie cycle student ]
write	neighbors : [ dog horror job machine poetry ]
oil	neighbors : [ horse comic job change language ]
opinion	neighbors : [ dog catholic husband finance poetry ]
fall	neighbors : [ pet hot job machine poetry ]
note	neighbors : [ horse dragon job note language ]
crazy	neighbors : [ horse clown job drug language ]
shopping	neighbors : [ dog dentist job trend painter ]
team	neighbors : [ pet gymnastics job machine college ]
blue	neighbors : [ cat youtube job pill roommate ]
footstep	neighbors : [ animal youth job addiction painter ]
fan	neighbors : [ pet lexus movie mind college ]
tomorrow	neighbors : [ cat dancer job dollar teacher ]
actor	neighbors : [ dog hollywood movie war teacher ]
actress	neighbors : [ dog hollywood job sense language ]
hill	neighbors : [ animal rap movie cell poetry ]
waiter	neighbors : [ eat georgia job relationship language ]
personality	neighbors : [ pet youth watch meditation student ]
dancer	neighbors : [ pet hip movie surgeon teacher ]
hippie	neighbors : [ pet freckle movie kitty doctor ]
politics	neighbors : [ pet symphony be politics project ]
sell	neighbors : [ ride florida picture sort language ]
jerry	neighbors : [ dog gymnastics movie type language ]
box	neighbors : [ pet youtube watch allergy language ]
basket	neighbors : [ pet rap watch week programming ]
smoothie	neighbors : [ cat yoga movie smoothie language ]
them	neighbors : [ horse youtube movie addiction teacher ]
brother	neighbors : [ dog bentley movie pain poetry ]
yes	neighbors : [ activity cheerleader movie machine poetry ]
trick	neighbors : [ pet bomb movie surgeon roommate ]
coach	neighbors : [ pet italy job peace poetry ]
georgia	neighbors : [ animal california movie nature college ]
violin	neighbors : [ animal dentist job the language ]
suppose	neighbors : [ pet tattoo job goal writer ]
on	neighbors : [ horse wan job org language ]
road	neighbors : [ cat friday job share language ]
horse	neighbors : [ horse horror job addiction alien ]
boat	neighbors : [ bet die movie allergy science ]
catch	neighbors : [ cat crime movie would student ]
prejudice	neighbors : [ pet youtube programmer bank architect ]
france	neighbors : [ animal japan watch change painter ]
trade	neighbors : [ pet chat movie military language ]
leader	neighbors : [ bos [num] job attitude library ]
duty	neighbors : [ pet posse kid kid college ]
therapy	neighbors : [ horse factory experience habit college ]
start	neighbors : [ dog youtube movie cash education ]
rest	neighbors : [ cat spain job machine bookstore ]
dessert	neighbors : [ eat dentist movie machine language ]
janitor	neighbors : [ horse japan job role poetry ]
cut	neighbors : [ pet club job pop software ]
syrup	neighbors : [ cat website job key teacher ]
cape	neighbors : [ toy gucci movie york poetry ]
talent	neighbors : [ pet grunge job brain publisher ]
veggie	neighbors : [ dog sucker movie flavor college ]
bad	neighbors : [ dog spain job model college ]
now	neighbors : [ horse youtube job condition education ]
planet	neighbors : [ pet ariel watch surgeon university ]
so	neighbors : [ pet horror movie war college ]
radio	neighbors : [ artist wayne watch alternative history ]
knife	neighbors : [ dog dancer job surgery language ]
episode	neighbors : [ red zombie watch vitamin scholarship ]
curator	neighbors : [ job houston job role painter ]
company	neighbors : [ animal nursing job power painter ]
bos	neighbors : [ cat miami movie mix language ]
medal	neighbors : [ lesson ufc california lesson language ]
week	neighbors : [ dog gal movie future scholarship ]
deadbeat	neighbors : [ dog yoga job recover college ]
leg	neighbors : [ pet crime job dollar student ]
pretty	neighbors : [ pet horror movie free college ]
agent	neighbors : [ dog intense job role language ]
discount	neighbors : [ animal africa meet pain scholarship ]
graduate	neighbors : [ pet ahahah film feeling college ]
depends	neighbors : [ animal chat job major doctor ]
father	neighbors : [ horse death job alcoholic program ]
reader	neighbors : [ dog youth job role scholarship ]
teaching	neighbors : [ pet dance pet key education ]
coat	neighbors : [ dog death job time library ]
want	neighbors : [ horse diego job mind library ]
quality	neighbors : [ cartoon code job sense college ]
loss	neighbors : [ dog cheer job finance college ]
doggy	neighbors : [ dog doggy movie chocolate doggy ]
cute	neighbors : [ dog buddhist bet skinny student ]
architect	neighbors : [ hobby superman job combat poetry ]
wedding	neighbors : [ horse paris movie type translator ]
experience	neighbors : [ cat dance job condition college ]
buy	neighbors : [ pet japan job attitude encyclopedia ]
seattle	neighbors : [ animal chicago job human college ]
market	neighbors : [ pet cheer job stress language ]
def	neighbors : [ pet comedy movie vegan soccer ]
hobbies	neighbors : [ pet bum movie weakness college ]
diabetic	neighbors : [ eat [num] job sugar language ]
bicycle	neighbors : [ cat cheer watch exercise language ]
trophy	neighbors : [ horse horror job type language ]
style	neighbors : [ dog facebook job my poetry ]
waste	neighbors : [ animal portrait movie me poetry ]
rat	neighbors : [ dog death job the education ]
department	neighbors : [ pet gaga movie civic language ]
stay	neighbors : [ pet chat movie unhealthy teacher ]
vinyl	neighbors : [ dog sex job ghost language ]
ballet	neighbors : [ animal ballet movie key poetry ]
sick	neighbors : [ cat skydive movie machine poetry ]
damage	neighbors : [ pet death job addiction college ]
professor	neighbors : [ horse youth job the language ]
speed	neighbors : [ pet unicorn movie machine college ]
kitchen	neighbors : [ pet pas job weakness history ]
singing	neighbors : [ eat funny hire key college ]
single	neighbors : [ animal paris movie your teacher ]
winner	neighbors : [ dog horror movie surgery therapist ]
japan	neighbors : [ dog paris movie push teacher ]
kindergarten	neighbors : [ eat france job strange language ]
student	neighbors : [ horse miami movie attitude student ]
blog	neighbors : [ cat saudi job weakness library ]
gotcha	neighbors : [ animal death watch account language ]
position	neighbors : [ cat dancer movie lifestyle language ]
bro	neighbors : [ cat skydive movie focus language ]
punk	neighbors : [ pet ta movie sort college ]
blood	neighbors : [ blood blonde job sense college ]
vacation	neighbors : [ dog santa movie government poetry ]
afford	neighbors : [ dog death job debt language ]
son	neighbors : [ dog bieber movie change student ]
dark	neighbors : [ pet dark movie mind intern ]
science	neighbors : [ pet hostage picture smart biology ]
force	neighbors : [ dog horror movie force language ]
fly	neighbors : [ animal fly film machine college ]
beagle	neighbors : [ dog ufc film exercise library ]
civil	neighbors : [ dog rap film free language ]
vet	neighbors : [ animal girl job drug teacher ]
nyu	neighbors : [ pet sex movie major college ]
'm	neighbors : [ pet chicago movie chemistry college ]
asparagus	neighbors : [ dog chat film jello college ]
fridge	neighbors : [ eat gotti job flavor language ]
pennsylvania	neighbors : [ pet youtube movie nature profession ]
christine	neighbors : [ horse horror movie fear language ]
goal	neighbors : [ pet cop watch goal teacher ]
climbing	neighbors : [ pet ferraris movie mind profession ]
medication	neighbors : [ horse google job med librarian ]
skydive	neighbors : [ horse skydive watch fund fund ]
train	neighbors : [ horse girlfriend job machine college ]
set	neighbors : [ cat movie movie stress language ]
math	neighbors : [ cat makeup movie weakness language ]
lab	neighbors : [ pet spain movie pain university ]
flow	neighbors : [ pet rap job machine college ]
nail	neighbors : [ dog tattoo job nature painter ]
apartment	neighbors : [ pet atlanta movie finance college ]
gym	neighbors : [ dog italy job binge teacher ]
guard	neighbors : [ pet rap watch finance librarian ]
cycling	neighbors : [ kid cheer job cycle poetry ]
problem	neighbors : [ pet rap job avoid language ]
kansa	neighbors : [ dog cop job rapid college ]
teen	neighbors : [ horse teen movie one profession ]
hr	neighbors : [ pet yoga job patient library ]
card	neighbors : [ horse dragon job condition language ]
fishing	neighbors : [ dog die movie lifestyle college ]
ireland	neighbors : [ pet blonde watch culture aunt ]
mountain	neighbors : [ dog rome movie condition poetry ]
chihuahua	neighbors : [ dog dancer job affair student ]
shelter	neighbors : [ pet nerd movie heart teacher ]
either	neighbors : [ dog young movie personality college ]
talk	neighbors : [ horse girlfriend job much homework ]
of	neighbors : [ dog porsche movie bank poetry ]
ball	neighbors : [ cat vampire watch balance language ]
security	neighbors : [ animal olympics watch question student ]
mary	neighbors : [ dog mary movie role university ]
serve	neighbors : [ horse shelter job military language ]
me	neighbors : [ language teenager guy share painter ]
chicago	neighbors : [ pet angeles job culture college ]
gamer	neighbors : [ pet sibling movie mind language ]
grad	neighbors : [ cat gymnastics job pill college ]
terrier	neighbors : [ pet hip movie choice college ]
diego	neighbors : [ horse metallica job empire language ]
therapist	neighbors : [ horse die job sore language ]
bmw	neighbors : [ animal bmw movie role language ]
loan	neighbors : [ pet bmw job role master ]
manager	neighbors : [ dog communist job lesson language ]
earth	neighbors : [ animal buddhist job war education ]
tupac	neighbors : [ dog rap california classic poetry ]
skin	neighbors : [ dog italy job skin doctor ]
smoke	neighbors : [ pet smoke job health chew ]
air	neighbors : [ animal spain watch war library ]
employment	neighbors : [ horse escape job lose outfit ]
netflix	neighbors : [ animal netflix watch security language ]
london	neighbors : [ animal comedy job philosophy language ]
costume	neighbors : [ animal theatre movie future college ]
estate	neighbors : [ horse bos job mind language ]
bread	neighbors : [ pet youth job key language ]
rapid	neighbors : [ dog chicago job rapid teacher ]
allergy	neighbors : [ pet ahahah job trouble language ]
process	neighbors : [ pet rap job thinking language ]
surgery	neighbors : [ dog chicago job deal college ]
virginia	neighbors : [ animal california movie civic language ]
craft	neighbors : [ dog ferrari movie client literature ]
yard	neighbors : [ pet jean job nature library ]
bf	neighbors : [ cat ferrari movie role language ]
distance	neighbors : [ pet horror movie mind poetry ]
yay	neighbors : [ cat ross job condition science ]
ate	neighbors : [ eat youtube movie relate teacher ]
count	neighbors : [ pet yoga movie trait language ]
fortunate	neighbors : [ cat italy job personality college ]
zoo	neighbors : [ sale crime job meditation language ]
symphony	neighbors : [ pet symphony job band language ]
preacher	neighbors : [ dog rap job strict library ]
garage	neighbors : [ pet divorce movie alcohol teacher ]
fiction	neighbors : [ dog superman job goal fiction ]
dragon	neighbors : [ pet dragon job activity student ]
metal	neighbors : [ pet genre film period teacher ]
coworker	neighbors : [ dog romance job allergic library ]
energy	neighbors : [ pet spain job energy language ]
sushi	neighbors : [ dog youtube movie jello painter ]
mix	neighbors : [ collar adult job workout language ]
barista	neighbors : [ eat clinic job chemistry poetry ]
youtube	neighbors : [ pet youtube watch org student ]
taller	neighbors : [ pet posse job finance student ]
taco	neighbors : [ dog friday watch stomach award ]
org	neighbors : [ horse dj salary force language ]
mirror	neighbors : [ portrait cheer car type language ]
judge	neighbors : [ horse cafe movie difference education ]
comfort	neighbors : [ dog downtown job surgeon teacher ]
very	neighbors : [ dog dungeon movie personality student ]
training	neighbors : [ kid france country goal teacher ]
share	neighbors : [ pet divorce job future language ]
no	neighbors : [ horse skydive film key teacher ]
indie	neighbors : [ dog scene movie pressure poetry ]
crime	neighbors : [ horse crime job pound student ]
outfit	neighbors : [ animal spain movie statement college ]
design	neighbors : [ cartoon parent job jello poetry ]
colour	neighbors : [ dog makeup car nervous student ]
education	neighbors : [ horse cheer job anxiety profession ]
financial	neighbors : [ pet cheer job stock education ]
desire	neighbors : [ horse youtube job influence poetry ]
vitamin	neighbors : [ horse [num] lazy united tutor ]
beat	neighbors : [ pet facebook movie addiction student ]
metallica	neighbors : [ pet metallica job key teacher ]
sleep	neighbors : [ dog chat job relate teacher ]
sight	neighbors : [ animal chat movie pain painter ]
tv	neighbors : [ dog youth watch exercise language ]
future	neighbors : [ pet cheer job future poetry ]
mushroom	neighbors : [ dog dentist job energy student ]
worried	neighbors : [ pet chat job pill college ]
iron	neighbors : [ eat friday job vitamin teacher ]
pittsburgh	neighbors : [ animal chat movie meditation poetry ]
ballerina	neighbors : [ dog kite job key college ]
mexican	neighbors : [ pet rap movie weakness language ]
yuck	neighbors : [ ride horror movie condition college ]
ticket	neighbors : [ animal dance movie punk psychology ]
nice	neighbors : [ dog eclipse movie condition language ]
moment	neighbors : [ animal chat job pain painter ]
humor	neighbors : [ dog friday movie impression language ]
list	neighbors : [ animal europe movie sort language ]
motorcycle	neighbors : [ dog fight job alcohol library ]
standard	neighbors : [ pet dragon film sort teacher ]
hmmm	neighbors : [ artist horror movie brain comedy ]
puppy	neighbors : [ dog cafe job war education ]
swimmer	neighbors : [ horse germany watch machine psychology ]
product	neighbors : [ dog spain job support library ]
recipe	neighbors : [ animal comic job share character ]
civic	neighbors : [ pet bmw movie lesson language ]
sweetheart	neighbors : [ animal dental watch relief language ]
festival	neighbors : [ animal coaster movie impression student ]
fabulous	neighbors : [ dog gaga job key poetry ]
online	neighbors : [ pet divorce job sort language ]
profession	neighbors : [ dog chat job spending college ]
meal	neighbors : [ eat makeup movie protein painter ]
pearl	neighbors : [ cat [num] movie pet college ]
grandparent	neighbors : [ dog boy movie finance profession ]
practice	neighbors : [ retriever skate movie war poetry ]
control	neighbors : [ burger dungeon job natural doctor ]
river	neighbors : [ bet dentist movie machine student ]
marathon	neighbors : [ horse germany job keto language ]
lunch	neighbors : [ eat francisco movie meditation psychology ]
meeting	neighbors : [ bunny chat movie culture library ]
beautiful	neighbors : [ horse france job unhealthy language ]
cup	neighbors : [ pet wayne job alcohol teacher ]
psychology	neighbors : [ skill chat movie skill engineering ]
jane	neighbors : [ pet makeup movie skin poet ]
base	neighbors : [ dog afford film pressure university ]
marine	neighbors : [ animal orleans job generation college ]
surprise	neighbors : [ dog skydive job culture education ]
inspiration	neighbors : [ kid skateboard job account poetry ]
normal	neighbors : [ pet clown job alcohol doctor ]
album	neighbors : [ shelter tattoo job ability college ]
taylor	neighbors : [ pet documentary movie bubble language ]
reason	neighbors : [ dog chat movie reason doctor ]
er	neighbors : [ job rap job patient night ]
ouch	neighbors : [ eat skydive movie war language ]
ankle	neighbors : [ pet tattoo job pain college ]
justin	neighbors : [ pet orleans movie role psychology ]
buddy	neighbors : [ dog europe holiday theme language ]
creek	neighbors : [ pet dentist movie machine language ]
war	neighbors : [ pet horror movie difference poetry ]
chick	neighbors : [ dog nike movie relationship doctor ]
dancing	neighbors : [ pet crime money exercise poetry ]
dish	neighbors : [ dog cream job flavor language ]
rep	neighbors : [ animal rap movie role language ]
beard	neighbors : [ animal death movie common language ]
player	neighbors : [ pet baltimore job key language ]
eagle	neighbors : [ animal chat movie medicine language ]
imagine	neighbors : [ music france movie future poetry ]
lesson	neighbors : [ pet dance movie fear language ]
pipe	neighbors : [ pet chicago job field teacher ]
police	neighbors : [ pet rap movie spending language ]
theme	neighbors : [ backyard dragon movie choice student ]
program	neighbors : [ animal [num] watch war language ]
queen	neighbors : [ animal dance job secret college ]
schooling	neighbors : [ cat spain job income college ]
culture	neighbors : [ cat america job cancer language ]
paint	neighbors : [ painting karate job mood poetry ]
rich	neighbors : [ horse [num] job rich college ]
president	neighbors : [ president california watch sweet language ]
landing	neighbors : [ dog chat film building college ]
england	neighbors : [ dog ma film type poetry ]
free	neighbors : [ horse dancer movie chemistry language ]
canadian	neighbors : [ joke skate job key language ]
industry	neighbors : [ pet tupac job development language ]
hunter	neighbors : [ animal europe eater surgeon language ]
move	neighbors : [ pet diego job avoid language ]
option	neighbors : [ pet ahahah movie free language ]
engineering	neighbors : [ painting [num] job medicine engineering ]
cheesecake	neighbors : [ dog figure film drug student ]
hire	neighbors : [ dog funny job machine painter ]
spoil	neighbors : [ dog skate movie personality college ]
mexico	neighbors : [ pet carolina job heart college ]
pant	neighbors : [ horse clutter job war library ]
knee	neighbors : [ pet facebook watch knee college ]
tennis	neighbors : [ cat dj job mix teacher ]
lawyer	neighbors : [ animal italy movie free poetry ]
project	neighbors : [ painting ufc job make poetry ]
horseback	neighbors : [ horse horse job introvert language ]
pop	neighbors : [ dog dancing movie alcohol poetry ]
deal	neighbors : [ animal bitcoin job deal poetry ]
ocd	neighbors : [ horse ahahah job ocd college ]
tiger	neighbors : [ cat zoo movie tiger language ]
john	neighbors : [ dog highschool movie power doctor ]
campus	neighbors : [ cat dorm job affair college ]
purple	neighbors : [ cat makeup job key aunt ]
taste	neighbors : [ pet indie job mind poetry ]
paper	neighbors : [ drawing tupac job healthy college ]
painful	neighbors : [ pet youtube job fear language ]
stock	neighbors : [ horse dabble job government language ]
maker	neighbors : [ eat youth watch power companion ]
rain	neighbors : [ dog halloween movie rapid science ]
walmart	neighbors : [ horse halo job medicine college ]
cooler	neighbors : [ dog humor movie overweight programming ]
telecom	neighbors : [ animal spain job finance language ]
happy	neighbors : [ pet skydive job use college ]
engineer	neighbors : [ dog [num] job feeling poetry ]
scientist	neighbors : [ horse gymnastics job key college ]
indian	neighbors : [ cat anime movie sense language ]
skittle	neighbors : [ cat skate watch weakness language ]
universe	neighbors : [ animal youth job promote education ]
sickness	neighbors : [ how youtube job soup teacher ]
vegetarian	neighbors : [ cat rap job sense college ]
driver	neighbors : [ pet girlfriend movie spending college ]
photo	neighbors : [ dog photography movie beet biography ]
picture	neighbors : [ pet studio job nature actor ]
aspiration	neighbors : [ dog horror job travel student ]
doberman	neighbors : [ dog dancer movie bingo profession ]
dorm	neighbors : [ dog dorm film share campus ]
wind	neighbors : [ animal dance movie personality poetry ]
push	neighbors : [ cat rap job attitude language ]
awe	neighbors : [ animal chat movie cancer language ]
material	neighbors : [ pet chicago job planet college ]
bake	neighbors : [ eat cheer watch condition language ]
athlete	neighbors : [ pet hollywood job weight teacher ]
field	neighbors : [ pet russian living bone language ]
grunge	neighbors : [ horse ballet movie reality college ]
fun	neighbors : [ pet toronto job the language ]
choir	neighbors : [ pet movie movie issue language ]
chop	neighbors : [ dog diego job power campus ]
jay	neighbors : [ animal kid movie model kid ]
tie	neighbors : [ pet skate movie husband college ]
live	neighbors : [ pet seattle horror difference language ]
background	neighbors : [ pet cheerleader movie war college ]
everyone	neighbors : [ animal chat job cancer poetry ]
pass	neighbors : [ pet cheer job nature language ]
strict	neighbors : [ cat posse job key teacher ]
cello	neighbors : [ cat comedy job the language ]
camera	neighbors : [ animal blonde job machine student ]
excellent	neighbors : [ dog dancer job sense student ]
buff	neighbors : [ animal horror movie key college ]
bieber	neighbors : [ horse hip job medicine college ]
good	neighbors : [ animal horror movie ability college ]
client	neighbors : [ pet dancer job finance language ]
valedictorian	neighbors : [ horse woman job machine college ]
drinking	neighbors : [ horse europe job mind college ]
poor	neighbors : [ dog dentist movie ability college ]
period	neighbors : [ coaster wayne movie oh college ]
environment	neighbors : [ pet freckle job pound college ]
biscuit	neighbors : [ dog zoo film sugar language ]
collie	neighbors : [ dog hop film cancer library ]
bar	neighbors : [ cat rap movie truth poetry ]
nut	neighbors : [ animal japan life target be ]
weather	neighbors : [ animal hop job sense college ]
beatles	neighbors : [ pet hip job soul poetry ]
touch	neighbors : [ pet cheerleader job attitude teacher ]
germany	neighbors : [ kid google job culture text ]
twilight	neighbors : [ horse twilight movie public language ]
mercedes	neighbors : [ dog paris job lesson language ]
along	neighbors : [ horse europe job condition college ]
piece	neighbors : [ pet death job key poetry ]
birth	neighbors : [ clothes bff job affair city ]
where	neighbors : [ pet chicago job retirement student ]
surf	neighbors : [ bet code movie income college ]
kinds	neighbors : [ pet skateboard watch any poetry ]
form	neighbors : [ horse skate job hide poetry ]
gutter	neighbors : [ animal toronto job machine library ]
vision	neighbors : [ cat dark watch vision watch ]
autobiography	neighbors : [ dog friday movie ocd poetry ]
ago	neighbors : [ pet youtube movie body language ]
television	neighbors : [ dog documentary watch society student ]
mop	neighbors : [ cat youth watch sort language ]
contact	neighbors : [ eat [num] job sense language ]
deaf	neighbors : [ cat gay job step literature ]
subway	neighbors : [ dog dance job sense student ]
pick	neighbors : [ pet chat movie share university ]
short	neighbors : [ pet skydive movie fat language ]
stick	neighbors : [ pet skate movie war poetry ]
folk	neighbors : [ cat metallica job type college ]
lifestyle	neighbors : [ cat miami job type college ]
shoe	neighbors : [ pet dancing job key poetry ]
path	neighbors : [ horse chicago job mind doctor ]
bartender	neighbors : [ horse battle job relationship language ]
tech	neighbors : [ animal blogger job ink library ]
grandchild	neighbors : [ pet death job chemistry teacher ]
raven	neighbors : [ animal festival movie power language ]
tackle	neighbors : [ pet rap watch war library ]
vintage	neighbors : [ horse death movie type student ]
tarot	neighbors : [ outdoors tarot job ability graduate ]
pride	neighbors : [ cat chat movie cancer architect ]
cake	neighbors : [ dog girlfriend film mass student ]
feeling	neighbors : [ cat france job cancer language ]
america	neighbors : [ dog escape job meditation language ]
hoop	neighbors : [ cat santa watch exercise poetry ]
scene	neighbors : [ dog dragon movie generation journalist ]
ramen	neighbors : [ pet burn meet truth student ]
equipment	neighbors : [ animal skate job respect thumb ]
rib	neighbors : [ eat butt watch mind university ]
greece	neighbors : [ bet greece job model college ]
reality	neighbors : [ dog scene job reason writing ]
finger	neighbors : [ pet dentist movie free poetry ]
tutor	neighbors : [ pet housewife job war student ]
easy	neighbors : [ pet dentist movie answer student ]
sausage	neighbors : [ pet dirty watch org language ]
spirit	neighbors : [ painting prison programmer share librarian ]
dr	neighbors : [ animal horror movie california education ]
idol	neighbors : [ dog anime watch relationship language ]
popcorn	neighbors : [ pet horror job teeth poetry ]
wednesday	neighbors : [ cat europe job body library ]
ink	neighbors : [ pet tattoo horror the language ]
steelers	neighbors : [ pet chat movie war poetry ]
cashier	neighbors : [ horse rap job bank student ]
nap	neighbors : [ pet chat job shift teacher ]
enough	neighbors : [ horse chat job machine language ]
medium	neighbors : [ painting park watch discovery college ]
instagram	neighbors : [ coat instagram soccer future painter ]
blanket	neighbors : [ drawing suck job 'd teacher ]
brunch	neighbors : [ cat funny movie weakness student ]
gathering	neighbors : [ kid chat movie type student ]
cheerleader	neighbors : [ horse sucker movie share master ]
allergic	neighbors : [ pet death job allergic dancer ]
border	neighbors : [ cat maryland film knee poetry ]
master	neighbors : [ horse youth job power college ]
pastime	neighbors : [ cat greece watch spending college ]
fur	neighbors : [ pet comedy job pain language ]
meatball	neighbors : [ dog funny movie strong poetry ]
smile	neighbors : [ animal youtube job addiction language ]
far	neighbors : [ horse france job mind college ]
confidence	neighbors : [ pet kansa job trend language ]
butterfly	neighbors : [ animal introvert job weight language ]
creed	neighbors : [ dog creed movie type poetry ]
wealthy	neighbors : [ horse diego job focus passion ]
cable	neighbors : [ animal coco watch role education ]
runner	neighbors : [ horse rap job war language ]
navy	neighbors : [ game skate job pain lesson ]
religion	neighbors : [ kid catholic watch habit father ]
quit	neighbors : [ eat documentary raise war college ]
crochet	neighbors : [ dog killer watch allergic writing ]
string	neighbors : [ cat sex movie another language ]
male	neighbors : [ animal sex movie sore language ]
spain	neighbors : [ dog med job type med ]
perfect	neighbors : [ toy chat movie sense language ]
dentist	neighbors : [ pet dentist movie retirement education ]
though	neighbors : [ pet horror movie machine language ]
recommend	neighbors : [ dog documentary movie sense poetry ]
editor	neighbors : [ job clothes job character college ]
superhero	neighbors : [ animal superman movie challenge doctor ]
competition	neighbors : [ cat dancer movie spirit painter ]
james	neighbors : [ pet austen movie vitamin student ]
stink	neighbors : [ kid portrait job asthma education ]
impressive	neighbors : [ animal baltimore movie therapist therapist ]
pug	neighbors : [ pet youtube movie pain poetry ]
custom	neighbors : [ cat dragon job exercise poetry ]
construction	neighbors : [ dog hop job income painter ]
lease	neighbors : [ cat bmw job finance language ]
nursing	neighbors : [ dog chat job pain painter ]
honda	neighbors : [ animal dance movie model language ]
budget	neighbors : [ dog bmw job situation student ]
biking	neighbors : [ pet bmw job info poetry ]
vera	neighbors : [ dog vera job finance language ]
pumpkin	neighbors : [ toy student movie fear student ]
usa	neighbors : [ dog rap job cancer library ]
diving	neighbors : [ horse funny job peace psychology ]
height	neighbors : [ breed dancer movie bank student ]
race	neighbors : [ dog nancy job tax language ]
hero	neighbors : [ pet superhero watch challenge stanford ]
ross	neighbors : [ pet skate watch org profession ]
brand	neighbors : [ job mouse job power library ]
italy	neighbors : [ animal italy watch model student ]
disney	neighbors : [ cat magical watch machine student ]
piano	neighbors : [ eat clinic job activity student ]
yum	neighbors : [ dog circus job exercise accountant ]
washington	neighbors : [ animal friday job human language ]
weekly	neighbors : [ cat adult job key scholarship ]
uncle	neighbors : [ cat miami movie military college ]
fit	neighbors : [ animal paris movie sort one ]
nomad	neighbors : [ artist tx job surgeon language ]
animation	neighbors : [ dog animation watch condition college ]
humane	neighbors : [ dog metallica job personality for ]
potato	neighbors : [ eat rap movie body language ]
tofu	neighbors : [ pet youtube job stress librarian ]
leaf	neighbors : [ animal madonna movie sort college ]
abigail	neighbors : [ animal paris movie sort poetry ]
peta	neighbors : [ dog rage salary personality college ]
panda	neighbors : [ horse panda watch reason therapist ]
mohican	neighbors : [ dog dark movie finance wife ]
adorable	neighbors : [ dog horror job state college ]
softball	neighbors : [ job freckle movie limit language ]
pharmacist	neighbors : [ pet rap job pain university ]
thriller	neighbors : [ horse crime watch fear author ]
skunk	neighbors : [ pet chat read spirit therapist ]
specialty	neighbors : [ dog death movie starve yum ]
difficult	neighbors : [ pet makeup movie power language ]
clown	neighbors : [ toy comedy movie scar language ]
tuna	neighbors : [ dog dance string machine education ]
cool	neighbors : [ pet video watch goal college ]
smart	neighbors : [ pet santa job mind student ]
midwest	neighbors : [ animal cali movie read library ]
silver	neighbors : [ pet rap film lose aunt ]
bite	neighbors : [ pet germany job lifestyle architect ]
breed	neighbors : [ pet horror movie addiction student ]
wood	neighbors : [ dog cheer movie machine teacher ]
denver	neighbors : [ animal britney job workout college ]
porsche	neighbors : [ animal romance movie fear language ]
level	neighbors : [ any baltimore job avoid teacher ]
iceland	neighbors : [ animal iceland job meditation accountant ]
canada	neighbors : [ pet chicago job activity psychology ]
warm	neighbors : [ dog karaoke job role library ]
attitude	neighbors : [ pet cheerleader job surgeon architect ]
step	neighbors : [ pet youth job war poetry ]
accept	neighbors : [ animal theater job architect architect ]
west	neighbors : [ animal francisco film heart engineering ]
xbox	neighbors : [ pet spain job pound college ]
turtle	neighbors : [ cat smoke job cancer college ]
cover	neighbors : [ pet dancing movie time college ]
advertising	neighbors : [ dog documentary watch type student ]
tube	neighbors : [ dog death job the language ]
alligator	neighbors : [ cat skydive movie surgeon language ]
candle	neighbors : [ pet nerd job save teacher ]
schedule	neighbors : [ cat rome job advanced college ]
biology	neighbors : [ riding graduation life administration biology ]
extra	neighbors : [ animal gossip job finance college ]
writing	neighbors : [ pet murder movie peace poetry ]
painter	neighbors : [ animal skateboard job nature painter ]
scotch	neighbors : [ animal death job allergic library ]
red	neighbors : [ job death job power apartment ]
robotics	neighbors : [ pet dark movie workout poetry ]
argue	neighbors : [ pet youtube job vitamin poetry ]
paramedic	neighbors : [ horse rap job war profession ]
difference	neighbors : [ horse chat movie difference language ]
toto	neighbors : [ pet europe country meditation college ]
spanish	neighbors : [ animal football job attention language ]
jewelry	neighbors : [ horse facebook movie secretary language ]
dental	neighbors : [ animal dentist job nature education ]
version	neighbors : [ pet cop movie role language ]
salary	neighbors : [ animal hip job finance university ]
fam	neighbors : [ cat fam job pop librarian ]
stew	neighbors : [ eat spain movie weakness language ]
africa	neighbors : [ horse africa movie surgery language ]
corvette	neighbors : [ horse chat watch machine language ]
trend	neighbors : [ horse tupac job choice nut ]
stamp	neighbors : [ dog dragon movie type author ]
bum	neighbors : [ horse india job alcohol language ]
photographer	neighbors : [ job skateboard movie type profession ]
perk	neighbors : [ animal cheerleader movie understood language ]
rainbow	neighbors : [ pet rap film key student ]
koala	neighbors : [ dog hop job government painter ]
tend	neighbors : [ dog drama film power bookstore ]
rent	neighbors : [ horse spain job drug student ]
basic	neighbors : [ pet nike movie key language ]
cash	neighbors : [ pet housewife job diet space ]
swimming	neighbors : [ eat makeup watch exercise master ]
studio	neighbors : [ pet studio job reason college ]
san	neighbors : [ horse angeles movie model poetry ]
stable	neighbors : [ pet solo job war graduate ]
addiction	neighbors : [ cat sevenfold job alcohol science ]
employee	neighbors : [ eat cheerleader job stress language ]
super	neighbors : [ know facebook hard promote language ]
chess	neighbors : [ pet chat movie fear student ]
eclipse	neighbors : [ farm rap movie deal language ]
post	neighbors : [ pet youtube job future college ]
austin	neighbors : [ animal austin film model language ]
foodie	neighbors : [ dog metallica job drinking painter ]
louisiana	neighbors : [ dog dancer actor bet profession ]
zebra	neighbors : [ pet dorm movie org philosophy ]
drawing	neighbors : [ animal skateboard job showing college ]
dallas	neighbors : [ animal nashville film role teacher ]
fell	neighbors : [ pet italy job sort language ]
shepard	neighbors : [ dog britney movie heart language ]
can	neighbors : [ dog dance job deal roommate ]
portrait	neighbors : [ painting skateboard job painting painter ]
landscape	neighbors : [ pet comedy job nature language ]
connect	neighbors : [ cat facebook job mind college ]
psychologist	neighbors : [ horse blonde job condition profession ]
rewarding	neighbors : [ horse youth job weakness poetry ]
corn	neighbors : [ eat cheerleader job vote education ]
worth	neighbors : [ pet chat job key language ]
boring	neighbors : [ cat skydive movie society language ]
nascar	neighbors : [ horse girlfriend movie government language ]
bulldog	neighbors : [ pet skydive job reality painter ]
irish	neighbors : [ pet girlfriend movie bank language ]
scout	neighbors : [ cat chicago movie one language ]
plumber	neighbors : [ horse cop job fine language ]
obsession	neighbors : [ job portrait job condition poetry ]
gf	neighbors : [ eat rap job happiness language ]
jog	neighbors : [ cat miami movie sense student ]
playing	neighbors : [ pet solo job avoid college ]
vancouver	neighbors : [ horse youth job pain reader ]
join	neighbors : [ horse youtube bulldog generation architect ]
europe	neighbors : [ cat europe movie surgery painter ]
ga	neighbors : [ horse california movie language college ]
break	neighbors : [ cat convention movie cash language ]
thing	neighbors : [ animal dragon job patient poetry ]
medicine	neighbors : [ horse horror job carb painting ]
're	neighbors : [ kid blonde job mind college ]
officer	neighbors : [ horse chat movie reward master ]
bummer	neighbors : [ cat skydive movie free teacher ]
doo	neighbors : [ cat trauma movie addiction college ]
interview	neighbors : [ pet funny movie brain language ]
yell	neighbors : [ dog youth job culture language ]
roommate	neighbors : [ cat clown job skin language ]
introvert	neighbors : [ cat youtube job sense student ]
jealous	neighbors : [ cat italy movie common student ]
onion	neighbors : [ dog dentist film power student ]
keto	neighbors : [ eat youtube job diet roommate ]
foster	neighbors : [ dog california job mind profession ]
than	neighbors : [ pet skydive job finance language ]
robert	neighbors : [ horse dirty movie model actor ]
cuisine	neighbors : [ dog youth movie war language ]
jessica	neighbors : [ dog jessica movie role language ]
climb	neighbors : [ dog snowboard dream finance library ]
community	neighbors : [ cat bitcoin job major profession ]
angel	neighbors : [ pet angel job ankle teacher ]
pudding	neighbors : [ eat europe movie gas student ]
playlist	neighbors : [ lab bruno movie sushi care ]
poetry	neighbors : [ animal youth life war poetry ]
too	neighbors : [ pet horror job mind doctor ]
who	neighbors : [ pet [num] job power poetry ]
dungeon	neighbors : [ pet hip movie avoid college ]
finish	neighbors : [ dog facebook job free science ]
los	neighbors : [ animal angeles job heart education ]
weed	neighbors : [ animal skate movie weed master ]
treat	neighbors : [ dog ta job cancer software ]
preschool	neighbors : [ eat young job protein college ]
take	neighbors : [ animal club movie risk architect ]
collection	neighbors : [ dog makeup movie attention shelter ]
champion	neighbors : [ cat karaoke watch color teacher ]
todd	neighbors : [ animal superman movie model poetry ]
fluent	neighbors : [ pet german job surgeon language ]
star	neighbors : [ dog fl movie org fiction ]
create	neighbors : [ toy cheerleader movie key poetry ]
grass	neighbors : [ pet india job personality library ]
whiskey	neighbors : [ horse club job stress language ]
date	neighbors : [ horse bff movie sort architect ]
daily	neighbors : [ pet skateboard movie surgery library ]
dane	neighbors : [ dog vegan job reality college ]
princess	neighbors : [ dog adult watch spending poetry ]
farming	neighbors : [ cat dorm movie routine college ]
genre	neighbors : [ dog indie movie cash student ]
web	neighbors : [ dog chat job condition student ]
factory	neighbors : [ pet horror job gas college ]
southern	neighbors : [ pet spain movie alcohol poetry ]
arizona	neighbors : [ pet arabia job meditation journalist ]
rare	neighbors : [ job death watch personality language ]
jello	neighbors : [ cat skate watch flavor language ]
mixed	neighbors : [ pet christian film flavor language ]
bag	neighbors : [ pet kpop movie depends programming ]
happiness	neighbors : [ horse cheer job happiness language ]
agree	neighbors : [ dog chat movie personality teacher ]
jean	neighbors : [ pet uncomfortable weather civic language ]
pen	neighbors : [ kid vienna job key poet ]
playoff	neighbors : [ cat chat watch lactose librarian ]
occupation	neighbors : [ dog tech job model therapist ]
pepperoni	neighbors : [ pet youtube watch sausage college ]
bright	neighbors : [ pet die job key education ]
wheelchair	neighbors : [ cat funny job happiness roommate ]
suburb	neighbors : [ animal chicago job machine poet ]
variety	neighbors : [ pet kj picture drug fiction ]
keep	neighbors : [ pet facebook job addiction teacher ]
lizard	neighbors : [ animal blonde movie juice alien ]
awhile	neighbors : [ cat nyc job mind painter ]
perform	neighbors : [ pet rap movie key poetry ]
challenge	neighbors : [ pet india watch fat poetry ]
technician	neighbors : [ animal comedy job step language ]
locate	neighbors : [ pet maryland picture meditation painter ]
gorgeous	neighbors : [ horse chat job free college ]
speaking	neighbors : [ kinds skate movie breath language ]
opportunity	neighbors : [ toy chat job cash student ]
iq	neighbors : [ horse test job color language ]
owe	neighbors : [ dog chat job debt poetry ]
quarterback	neighbors : [ dog bitcoin movie free college ]
league	neighbors : [ dog chat movie autobiography language ]
toddler	neighbors : [ linebacker swim job my college ]
news	neighbors : [ animal chat film mind college ]
fantasy	neighbors : [ horse action watch nature poetry ]
homemade	neighbors : [ dog dentist movie bank poetry ]
cult	neighbors : [ toy cult watch communist father ]
stage	neighbors : [ pet yoga job gas language ]
tutorial	neighbors : [ pet youtube movie content library ]
trainer	neighbors : [ horse horror job workout language ]
relaxing	neighbors : [ pet clown job action teacher ]
vega	neighbors : [ dog convention job pill college ]
german	neighbors : [ kid weather job intelligent language ]
employ	neighbors : [ dog chef job brain teacher ]
political	neighbors : [ animal shelter movie mind poetry ]
dry	neighbors : [ toy europe job thinking library ]
angeles	neighbors : [ pet angeles movie heart poetry ]
puzzle	neighbors : [ pet makeup movie war language ]
scratch	neighbors : [ pet italy movie vitamin language ]
mechanic	neighbors : [ animal cheer movie it language ]
pup	neighbors : [ dog germany job cancer education ]
dairy	neighbors : [ eat wayne job gas poetry ]
prince	neighbors : [ dog rap movie chemistry aunt ]
hendrix	neighbors : [ dog tupac job vitamin language ]
mike	neighbors : [ mike ufc movie trend poetry ]
float	neighbors : [ dog youth job pop student ]
amazon	neighbors : [ horse spain job chemistry language ]
army	neighbors : [ pet cali movie pain college ]
drunk	neighbors : [ animal chat movie recover language ]
adequate	neighbors : [ pet chat job condition doctor ]
rude	neighbors : [ pet chat job vitamin language ]
mermaid	neighbors : [ bet skate job version student ]
arabia	neighbors : [ toy def job culture language ]
curly	neighbors : [ pet nerd movie addiction college ]
leprechaun	neighbors : [ pet skateboard movie model student ]
fight	neighbors : [ pet fight singer question doctor ]
arcade	neighbors : [ pet horror watch condition college ]
scooter	neighbors : [ cat francisco movie push language ]
homebody	neighbors : [ pet facebook watch role college ]
mural	neighbors : [ painting mural job answer student ]
epilepsy	neighbors : [ pet [num] job sugar clothes ]
nacho	neighbors : [ dog death watch choice poetry ]
dope	neighbors : [ pet tombraider job goal psychology ]
salmon	neighbors : [ pet youtube job machine profession ]
aww	neighbors : [ dog youtube movie future teacher ]
computer	neighbors : [ pet spain job weakness student ]
sitcom	neighbors : [ dog documentary watch war college ]
compete	neighbors : [ dog gymnastics arm improve rough ]
chain	neighbors : [ pet random movie sort husband ]
depressed	neighbors : [ pet skateboard job avoid father ]
detroit	neighbors : [ horse detroit service drug engineering ]
publishing	neighbors : [ cat posse picture future publish ]
wizard	neighbors : [ pet dragon movie iphone student ]
sweater	neighbors : [ pet nerd movie on language ]
kpop	neighbors : [ horse horror job condition language ]
toronto	neighbors : [ animal youth job income language ]
fault	neighbors : [ pet barefoot job avoid employee ]
offer	neighbors : [ dog skydive job vitamin library ]
purpose	neighbors : [ pet horror tough brain poetry ]
volcano	neighbors : [ horse spain job poetry poetry ]
attend	neighbors : [ cat europe movie [num] scholarship ]
miley	neighbors : [ dog hip movie vitamin teacher ]
del	neighbors : [ horse med job weakness student ]
documentary	neighbors : [ pet documentary watch war subject ]
time	neighbors : [ pet spain movie secret universe ]
volunteer	neighbors : [ horse anime movie spending language ]
peaceful	neighbors : [ pet chat movie purpose education ]
snorkel	neighbors : [ cat skydive movie fear psychology ]
screen	neighbors : [ eat youtube watch sense doctor ]
rage	neighbors : [ horse kale job major writer ]
snap	neighbors : [ pet chat blow relieve painter ]
lol	neighbors : [ basic jerk movie goal language ]
alaska	neighbors : [ dog ga job meditation language ]
burrito	neighbors : [ pet rap job binge teacher ]
railroad	neighbors : [ pet videogames job cancer psychology ]
nation	neighbors : [ dog symphony watch share language ]
dabble	neighbors : [ job youtube job condition college ]
pretzel	neighbors : [ pet youth watch feed language ]
penny	neighbors : [ dog europe movie key college ]
weld	neighbors : [ pet football movie fat language ]
eater	neighbors : [ dog cuisine movie weight language ]
stephen	neighbors : [ animal hp movie sort poetry ]
keyboard	neighbors : [ meat cheerleader movie sense doctor ]
skiing	neighbors : [ dog skateboard movie relationship poetry ]
colorado	neighbors : [ animal skydive job mass teacher ]
cleaning	neighbors : [ cat kj movie energy student ]
labrador	neighbors : [ dog hop job happy alien ]
together	neighbors : [ cat studio job war program ]
upstate	neighbors : [ pet dentist job machine language ]
dealer	neighbors : [ animal be watch balance language ]
suggestion	neighbors : [ pet dragon job heart student ]
administration	neighbors : [ animal spain job administration language ]
choose	neighbors : [ pet mouse watch any college ]
center	neighbors : [ animal rap job workout language ]
mansion	neighbors : [ eat youtube job condition engineering ]
magically	neighbors : [ pet youtube job surgeon college ]
spider	neighbors : [ pet kj movie fear student ]
ability	neighbors : [ pet instagram movie key language ]
jerky	neighbors : [ pet cheerleader watch truth internship ]
surfing	neighbors : [ dog surfer movie trouble college ]
buck	neighbors : [ animal hampshire job surgery library ]
wild	neighbors : [ horse adult job generation painter ]
sleeve	neighbors : [ pet tattoo job sort language ]
safety	neighbors : [ pet die job skin teacher ]
crave	neighbors : [ cat youtube job weakness architect ]
gas	neighbors : [ horse comic job gas history ]
receptionist	neighbors : [ animal rap job role student ]
magic	neighbors : [ pet madonna movie tap hear ]
internship	neighbors : [ dog bmw job focus college ]
site	neighbors : [ dog chat film loner student ]
sevenfold	neighbors : [ pet death job remember college ]
struggle	neighbors : [ retriever art job anxiety literature ]
promise	neighbors : [ cat europe job credit teacher ]
support	neighbors : [ horse chat job spending poetry ]
monday	neighbors : [ cat europe movie body library ]
belt	neighbors : [ pet funny watch war college ]
expensive	neighbors : [ animal spain movie sense poetry ]
most	neighbors : [ dog dancer movie free college ]
sunny	neighbors : [ animal ballet job pill library ]
celtic	neighbors : [ pet dirty movie chemistry poetry ]
indoors	neighbors : [ pet die job machine library ]
upholstery	neighbors : [ horse sex job florida roommate ]
surgeon	neighbors : [ dog death job surgery profession ]
tiki	neighbors : [ poodle die programmer national alien ]
relieve	neighbors : [ dog nerd job generation college ]
loner	neighbors : [ pet clown job war college ]
gender	neighbors : [ horse youtube job gender language ]
jamaica	neighbors : [ cat jamaica job exercise college ]
ymca	neighbors : [ cat ymca job health student ]
blast	neighbors : [ animal spain movie diet psychology ]
consulting	neighbors : [ eat play job finance language ]
lkjsklsk	neighbors : [ dog [num] job allergic language ]
jam	neighbors : [ pet chick movie exercise teacher ]
daycare	neighbors : [ dog boy job income teacher ]
nope	neighbors : [ eat youtube watch surgeon language ]
regular	neighbors : [ pet wayne job alcohol teacher ]
pitbulls	neighbors : [ pet dorm color reality student ]
dang	neighbors : [ cat cafe watch workout student ]
backyard	neighbors : [ pet skate job free accountant ]
raptor	neighbors : [ horse rap job power language ]
nephew	neighbors : [ animal dentist job spending student ]
crack	neighbors : [ game skate job sense language ]
bucket	neighbors : [ animal portrait job difference accounting ]
carbs	neighbors : [ eat genre movie sugar language ]
left	neighbors : [ pet baltimore job surgeon college ]
cart	neighbors : [ cat youtube movie condition language ]
michael	neighbors : [ pet skydive movie surgeon psychology ]
warmer	neighbors : [ dog kansan job overweight student ]
cleveland	neighbors : [ pet miami brown mind language ]
cheer	neighbors : [ cat cheerleader experience pain education ]
bella	neighbors : [ dog dancer job vitamin language ]
long	neighbors : [ horse diego job introvert language ]
yr	neighbors : [ breed ahahah movie step language ]
mini	neighbors : [ cat dentist film trouble language ]
evil	neighbors : [ music benefit job fear doctor ]
protect	neighbors : [ cat film movie bank language ]
jack	neighbors : [ animal dirty movie type student ]
comedienne	neighbors : [ dog chat watch cheer language ]
blackjack	neighbors : [ pet miami job focus language ]
average	neighbors : [ dog crime job mind language ]
trout	neighbors : [ dog francisco movie allergic father ]
eyesight	neighbors : [ dog spain job mind language ]
pregnant	neighbors : [ dog [num] job sort college ]
thai	neighbors : [ eat france movie story language ]
anatomy	neighbors : [ animal kid movie bank college ]
racing	neighbors : [ horse olympics job machine language ]
honest	neighbors : [ dog chat movie military language ]
someone	neighbors : [ dog youth movie mind language ]
thankful	neighbors : [ dog europe job surgeon college ]
stain	neighbors : [ game skate job mind companion ]
childhood	neighbors : [ cat spain movie change college ]
skate	neighbors : [ cat skate watch health teacher ]
debt	neighbors : [ animal youtube job debt painter ]
right	neighbors : [ animal youtube job diabetes education ]
thrill	neighbors : [ horse [num] job the author ]
print	neighbors : [ pet death movie future teacher ]
bunny	neighbors : [ pet boy movie therapy college ]
bubble	neighbors : [ pet skate watch bubble language ]
intern	neighbors : [ animal [num] job role language ]
charlie	neighbors : [ dog dentist job lifestyle language ]
return	neighbors : [ dog youtube job agreed language ]
brush	neighbors : [ pet dentist job skin poet ]
tour	neighbors : [ dog [num] job exercise subtitle ]
hamilton	neighbors : [ horse rap watch addict language ]
hummingbird	neighbors : [ animal france job spending father ]
combat	neighbors : [ pet britney whoa most doctor ]
exam	neighbors : [ pet comic movie medicine language ]
wine	neighbors : [ animal opera job gas author ]
machine	neighbors : [ dog dancer job spending student ]
deliver	neighbors : [ pet cheer job exercise library ]
viking	neighbors : [ car die read goodwill translator ]
retail	neighbors : [ pet bitcoin job alcohol language ]
silly	neighbors : [ pet website watch truth poetry ]
hollywood	neighbors : [ animal hollywood movie condition poetry ]
barbecue	neighbors : [ dog rage watch lifestyle greek ]
manta	neighbors : [ horse youth experience rid alien ]
scar	neighbors : [ dog death movie surgery poet ]
sky	neighbors : [ kid india job key college ]
hopefully	neighbors : [ cat germany job condition language ]
born	neighbors : [ job france job sort biology ]
social	neighbors : [ horse chat job mind student ]
renovate	neighbors : [ cat greece job meditation poet ]
planner	neighbors : [ toy [num] job meditation language ]
teeth	neighbors : [ pet death job society education ]
understood	neighbors : [ pet rap job major language ]
moon	neighbors : [ grow miami movie strong education ]
ft	neighbors : [ pet divorce movie finance college ]
adult	neighbors : [ horse google movie mind profession ]
pyramid	neighbors : [ dog facebook watch difference poetry ]
slave	neighbors : [ pet slave movie pain food ]
wow	neighbors : [ dog europe cat lose language ]
gummy	neighbors : [ pet death watch flavor college ]
rn	neighbors : [ dog housewife job major library ]
ship	neighbors : [ horse spain job feeling psychology ]
skill	neighbors : [ pet katy movie weakness language ]
jacket	neighbors : [ animal miami movie pain college ]
crystal	neighbors : [ pet rap film color language ]
jousting	neighbors : [ pet unicycle watch freeze hunting ]
gun	neighbors : [ animal cheerleader watch content poet ]
cousin	neighbors : [ cat dentist movie spending student ]
pot	neighbors : [ animal butt job finance language ]
graduation	neighbors : [ animal bitcoin job machine college ]
stressful	neighbors : [ toy paris job process library ]
tahoe	neighbors : [ dog die job finance library ]
grandpa	neighbors : [ animal boy movie finance language ]
everything	neighbors : [ cat spain job war poetry ]
side	neighbors : [ horse youtube job machine student ]
search	neighbors : [ horse chat picture difference student ]
pottery	neighbors : [ cat posse movie relationship poetry ]
supportive	neighbors : [ cat shelter job cancer doctor ]
drama	neighbors : [ horse documentary experience suggestion language ]
encyclopedia	neighbors : [ horse death job art husband ]
retired	neighbors : [ pet history watch tofu history ]
diabetes	neighbors : [ diabetic [num] job sugar poetry ]
range	neighbors : [ puppy skydive job pain language ]
pack	neighbors : [ pet kansa job alcohol language ]
reincarnate	neighbors : [ cat tupac job health alien ]
lens	neighbors : [ pet toe job dollar language ]
rugby	neighbors : [ horse kite watch lesson language ]
kite	neighbors : [ dog horror movie idea college ]
rome	neighbors : [ dog [num] job vitamin text ]
common	neighbors : [ dog clown job alcohol teacher ]
series	neighbors : [ animal csi job role text ]
avid	neighbors : [ dog jessica picture finance language ]
cattle	neighbors : [ horse cheerleader job grandfather language ]
sew	neighbors : [ cat youth job cancer language ]
mmmm	neighbors : [ eat clown job brain teacher ]
gal	neighbors : [ dog pic job finance language ]
participate	neighbors : [ horse [num] watch any architect ]
joe	neighbors : [ horse miami movie nature language ]
santa	neighbors : [ pet rap job empire poetry ]
montecito	neighbors : [ dog georgia job finance actor ]
alpaca	neighbors : [ dog italy watch rid therapist ]
release	neighbors : [ animal pay job avoid college ]
comedian	neighbors : [ toy cheer watch war language ]
carolina	neighbors : [ cat bff movie nature psychology ]
pull	neighbors : [ dog chat job dollar language ]
performance	neighbors : [ pet solo movie keto poetry ]
continue	neighbors : [ dog youtube job addiction education ]
first	neighbors : [ pet bitcoin job chemistry library ]
pork	neighbors : [ eat wayne job shift student ]
cod	neighbors : [ horse mouse job stress library ]
welfare	neighbors : [ eat salon job welfare profession ]
soon	neighbors : [ pet europe job mind college ]
oregon	neighbors : [ cat arabia movie machine poetry ]
hop	neighbors : [ pet rapper job current student ]
boxer	neighbors : [ pet dance movie cancer graduate ]
senior	neighbors : [ dog [num] movie finance language ]
poop	neighbors : [ horse youtube job recover college ]
beet	neighbors : [ dog club job allergic college ]
sour	neighbors : [ pet youtube job addiction student ]
poet	neighbors : [ animal youth job mind poet ]
demand	neighbors : [ pet piercings job relief language ]
welcome	neighbors : [ animal chat job condition poetry ]
noise	neighbors : [ dog friday job fear teacher ]
wildlife	neighbors : [ dog comedy job surgeon student ]
circus	neighbors : [ animal circus job main language ]
petition	neighbors : [ horse anime job petition architect ]
cycle	neighbors : [ cat skateboard job cycle profession ]
place	neighbors : [ animal france job mind painter ]
drop	neighbors : [ pet skydive job mind language ]
tom	neighbors : [ beautiful algeria movie cancer language ]
clinic	neighbors : [ dog metallica movie background teacher ]
interest	neighbors : [ horse website job bank author ]
invite	neighbors : [ cat invite job condition architect ]
packer	neighbors : [ dog rap movie relationship college ]
macaroni	neighbors : [ pet skateboard movie body language ]
publisher	neighbors : [ dog sport picture change professor ]
flag	neighbors : [ horse solo movie color language ]
sexy	neighbors : [ horse youth job war language ]
pitbull	neighbors : [ pet death watch death grandparent ]
switch	neighbors : [ horse wayne watch mouth student ]
hectic	neighbors : [ pet nerd job free college ]
lit	neighbors : [ cat comedy job care student ]
cosmetic	neighbors : [ cat divorce job weakness college ]
direct	neighbors : [ pet horror movie direct student ]
sucker	neighbors : [ dog ta movie band language ]
settle	neighbors : [ cat youtube job finance companion ]
investment	neighbors : [ pet cheer job key language ]
mac	neighbors : [ cat rap job nature bookstore ]
unicycle	neighbors : [ toy unicycle watch government power ]
hotdog	neighbors : [ dog youtube movie promotion language ]
private	neighbors : [ horse dancer job free language ]
earring	neighbors : [ horse facebook watch choice language ]
inner	neighbors : [ pet chicago job vitamin language ]
minimum	neighbors : [ pet murder job finance college ]
videogames	neighbors : [ pet surfer watch pill college ]
unfortunate	neighbors : [ dog chat job generation architect ]
gossip	neighbors : [ horse gossip job condition magazine ]
matt	neighbors : [ dog comedy movie vitamin language ]
miss	neighbors : [ cat skydive watch role poetry ]
ferraris	neighbors : [ horse [num] good drug language ]
crowd	neighbors : [ horse cheerleader job bank education ]
block	neighbors : [ pet skydive movie fear language ]
seizure	neighbors : [ pet spain job medication subject ]
unicorn	neighbors : [ horse netflix service generation college ]
arae	neighbors : [ balance sun em stress sheeran ]
solo	neighbors : [ eat [num] roll weight poetry ]
planning	neighbors : [ toy france job finance student ]
piercings	neighbors : [ horse chat movie pain history ]
fancy	neighbors : [ animal cheerleader job cancer college ]
article	neighbors : [ horse chat film may student ]
the	neighbors : [ pet travel movie smart translator ]
thrift	neighbors : [ cat metallica job type language ]
librarian	neighbors : [ animal hip job retirement library ]
cookbook	neighbors : [ dog mystery job skin student ]
podcasts	neighbors : [ pet rap job retirement scholarship ]
grateful	neighbors : [ dog perk job surgeon architect ]
windy	neighbors : [ animal skate movie personality poetry ]
light	neighbors : [ pet gymnastics experience workout sci ]
suspender	neighbors : [ cat profession job free college ]
cope	neighbors : [ dog skydive job the teacher ]
alabama	neighbors : [ bet nevada movie sense college ]
em	neighbors : [ cat europe job energy drawing ]
magical	neighbors : [ pet spain job condition college ]
um	neighbors : [ language rapper job alcohol language ]
la	neighbors : [ dog hip movie mind language ]
harley	neighbors : [ dog death job control library ]
admit	neighbors : [ pet chat job fear poetry ]
remodel	neighbors : [ dog butt job security librarian ]
indiana	neighbors : [ animal fan movie stress language ]
director	neighbors : [ dog comedy car direct language ]
volleyball	neighbors : [ eat rap watch welfare language ]
french	neighbors : [ pet tu movie attention language ]
anne	neighbors : [ dog skate movie role poetry ]
tank	neighbors : [ pet horror job generation language ]
disappoint	neighbors : [ dog chat job role star ]
interesting	neighbors : [ pet chat job mind language ]
zumba	neighbors : [ cat chef watch weakness literature ]
cuba	neighbors : [ dog cuba movie mind college ]
drummer	neighbors : [ pet chicago job type teacher ]
[num]pac	neighbors : [ dog ufc job condition college ]
curry	neighbors : [ dog thai job selfish student ]
gambler	neighbors : [ dog europe goal finance student ]
alive	neighbors : [ pet skateboard job surgeon college ]
already	neighbors : [ cat blonde job war college ]
hubby	neighbors : [ pet twilight movie role teacher ]
tear	neighbors : [ dog chat job machine teacher ]
insurance	neighbors : [ animal documentary employee mix library ]
expand	neighbors : [ cat italy job mind language ]
decorate	neighbors : [ dog horror movie meditation teacher ]
king	neighbors : [ eat si job question language ]
wall	neighbors : [ pet funny job sense college ]
depression	neighbors : [ pet facebook job mind language ]
direction	neighbors : [ horse france job empire college ]
joint	neighbors : [ pet louisiana chocolate cell apply ]
announcer	neighbors : [ dog smoke job role college ]
world	neighbors : [ cat cheer job share poetry ]
clothing	neighbors : [ horse metallica job war doctor ]
safe	neighbors : [ dog chicago job free language ]
nearby	neighbors : [ dog dentist job machine student ]
press	neighbors : [ animal ballet movie future architect ]
lay	neighbors : [ cat europe job meditation library ]
hyper	neighbors : [ toy chat watch mind language ]
distract	neighbors : [ cat escape movie relate college ]
nba	neighbors : [ pet rap job goal language ]
larp	neighbors : [ living lesson watch support event ]
interior	neighbors : [ dog hip job cancer language ]
karma	neighbors : [ cat skydive job war architect ]
traditional	neighbors : [ horse nerd movie bank teacher ]
bull	neighbors : [ animal skydive watch reason library ]
ferret	neighbors : [ horse youth read cancer profession ]
creative	neighbors : [ pet youth job acting language ]
pediatrician	neighbors : [ horse chicago job shift college ]
tradition	neighbors : [ cat youth job bank language ]
telenovela	neighbors : [ dog ticket watch ticket language ]
musical	neighbors : [ eat funny movie war poetry ]
tooth	neighbors : [ animal dentist job society living ]
course	neighbors : [ pet comic movie mind poetry ]
autism	neighbors : [ pet dance job challenge father ]
gluten	neighbors : [ pet germany job avoid poetry ]
closet	neighbors : [ animal playlist job meditation parent ]
east	neighbors : [ pet france film push poetry ]
survive	neighbors : [ pet instagram job body science ]
condition	neighbors : [ dog spain job child doctor ]
luis	neighbors : [ horse rap movie heart bone ]
vienna	neighbors : [ dog france job vitamin language ]
ground	neighbors : [ collar miley job generation teacher ]
brat	neighbors : [ bunny death job pain college ]
need	neighbors : [ pet chat job alcohol librarian ]
scuba	neighbors : [ horse blonde job fear college ]
teenager	neighbors : [ pet santa job medication poet ]
acre	neighbors : [ dog cheerleader job lactose doctor ]
ingredient	neighbors : [ toy fallon film alcohol eye ]
rag	neighbors : [ job death job alcohol college ]
csi	neighbors : [ animal crime job role schedule ]
smithsonian	neighbors : [ pet living movie addiction language ]
dodge	neighbors : [ pet word movie civic language ]
harry	neighbors : [ practice dirty movie sort student ]
eyebrow	neighbors : [ horse makeup job responsibility university ]
wish	neighbors : [ dog diego job personality poetry ]
talented	neighbors : [ pet grandchild movie weakness college ]
easter	neighbors : [ animal jump movie hide poetry ]
knit	neighbors : [ animal fi job cancer teacher ]
maiden	neighbors : [ animal youth job personality program ]
benefit	neighbors : [ cat spain job medicine psychology ]
aquarium	neighbors : [ cat clothes job freedom painter ]
wage	neighbors : [ animal bos job tax employee ]
bc	neighbors : [ joke intense job meditation therapist ]
fiance	neighbors : [ cat greece job free college ]
clutter	neighbors : [ grandparent file job reason college ]
wound	neighbors : [ pet chat job surgery education ]
clerk	neighbors : [ eat skate job patient language ]
best	neighbors : [ dog documentary movie free library ]
snowboard	neighbors : [ dog snowboard movie war language ]
jason	neighbors : [ dog george movie model language ]
theatre	neighbors : [ eat genre movie avoid poetry ]
correct	neighbors : [ kinds cheerleader movie strict poetry ]
territory	neighbors : [ pet france movie machine language ]
weak	neighbors : [ pet nerd experience weakness language ]
'll	neighbors : [ cat europe movie cancer college ]
harsh	neighbors : [ toy friday movie vitamin teacher ]
attic	neighbors : [ pet die job condition college ]
kind	neighbors : [ horse youtube job addiction language ]
pressure	neighbors : [ dog blonde job pressure student ]
fuel	neighbors : [ animal comic job diet language ]
upset	neighbors : [ dog downtown job allergic psychology ]
basement	neighbors : [ dog die movie secret college ]
si	neighbors : [ dog bella watch support language ]
rico	neighbors : [ cat rico watch united therapist ]
fire	neighbors : [ pet death job key poetry ]
translator	neighbors : [ language bang job attention language ]
white	neighbors : [ horse field film mind language ]
fantastic	neighbors : [ animal [num] job sense language ]
noble	neighbors : [ dog cheer watch volunteer volunteer ]
gardening	neighbors : [ dog die job weakness student ]
mouse	neighbors : [ dog pretty movie change student ]
soup	neighbors : [ eat spain job theme language ]
pillage	neighbors : [ history russian crash history education ]
yet	neighbors : [ animal youtube job condition poetry ]
fighter	neighbors : [ horse rap watch finance language ]
become	neighbors : [ dog spain job power college ]
brewery	neighbors : [ animal rap job truth master ]
rough	neighbors : [ animal shoot job depress library ]
jeopardy	neighbors : [ dog blonde experience war student ]
delivery	neighbors : [ pet [num] movie relationship library ]
kiddos	neighbors : [ cat germany job bank college ]
local	neighbors : [ pet girlfriend movie alcohol painter ]
once	neighbors : [ pet chicago job machine college ]
raise	neighbors : [ eat shelter job difference profession ]
gum	neighbors : [ horse check job gum 's ]
rapper	neighbors : [ dog japan job empire therapist ]
stressed	neighbors : [ pet blonde job war college ]
attack	neighbors : [ pet dragon film fear student ]
society	neighbors : [ cat cheer job future kid ]
bully	neighbors : [ dog youtube job stress language ]
stress	neighbors : [ pet facebook job stress college ]
national	neighbors : [ horse youth watch war language ]
kick	neighbors : [ eat rap watch war library ]
effect	neighbors : [ pet cheer job war doctor ]
sewing	neighbors : [ cat europe job cancer poetry ]
fart	neighbors : [ eat rap movie scar language ]
wikipedia	neighbors : [ animal rap job power language ]
brian	neighbors : [ animal ufc movie war language ]
boot	neighbors : [ pet skydive film pain library ]
exhaust	neighbors : [ dog ta job government college ]
still	neighbors : [ pet youtube job war college ]
current	neighbors : [ pet metallica job pop language ]
uk	neighbors : [ rico rico car cancer father ]
mostly	neighbors : [ pet nerd movie soul college ]
tape	neighbors : [ dog skate movie trick trick ]
dreary	neighbors : [ cat nerd job society language ]
patient	neighbors : [ dog chat job deal language ]
dip	neighbors : [ cat dentist job involve language ]
zombie	neighbors : [ pet tarot movie choice language ]
purchase	neighbors : [ pet bitcoin job patient watch ]
shelf	neighbors : [ cat cheer sad ability or ]
again	neighbors : [ cat chat job social language ]
unique	neighbors : [ dog chill job dollar college ]
frank	neighbors : [ dog dirty movie playoff language ]
detective	neighbors : [ painting drama job spending language ]
help	neighbors : [ pet ny job heart poetry ]
lead	neighbors : [ jay sex job favor college ]
tease	neighbors : [ toy youtube movie bank poetry ]
sword	neighbors : [ sword britney watch ability language ]
balance	neighbors : [ pet cheerleader job stress teacher ]
ironic	neighbors : [ horse mouse job personality poetry ]
rockies	neighbors : [ animal britney job meditation language ]
off	neighbors : [ animal youtube job cancer psychology ]
faith	neighbors : [ dog angel job pop doctor ]
pursue	neighbors : [ mood studio job personality college ]
lesbian	neighbors : [ cat bar movie shift language ]
temper	neighbors : [ toy horror job shift teacher ]
glacier	neighbors : [ dog dentist job war university ]
subtitle	neighbors : [ sound anime experience mind subtitle ]
radiohead	neighbors : [ pet metallica job rest college ]
ontario	neighbors : [ cat youth job meditation father ]
every	neighbors : [ dog [num] job jello library ]
consume	neighbors : [ eat europe job weakness college ]
adore	neighbors : [ cat chat job cancer college ]
or	neighbors : [ movie youtube movie bank language ]
curl	neighbors : [ cat curl life knee student ]
concern	neighbors : [ horse cheerleader job weakness language ]
nutrition	neighbors : [ horse chat job machine language ]
wet	neighbors : [ cat dentist job the painter ]
his	neighbors : [ pet miami movie your language ]
oreo	neighbors : [ horse girlfriend film condition poetry ]
new	neighbors : [ pet adult job key poetry ]
koi	neighbors : [ dog dentist job chemistry language ]
semi	neighbors : [ cat therapist job healthy therapist ]
nike	neighbors : [ pet rap job account college ]
physical	neighbors : [ pet cheer job weakness language ]
figurine	neighbors : [ dog figurine job type student ]
escape	neighbors : [ dog crime movie free podcasts ]
jasper	neighbors : [ dog dirty movie be language ]
rx	neighbors : [ cat europe job cancer florida ]
woodstock	neighbors : [ hubby gymnastics movie exercise college ]
bitcoin	neighbors : [ pet bitcoin job message library ]
coaster	neighbors : [ horse ta job allergic poetry ]
line	neighbors : [ animal youth job vitamin doctor ]
inch	neighbors : [ animal death job pain library ]
indeed	neighbors : [ animal spain job machine poetry ]
honestly	neighbors : [ school youtube movie role language ]
dye	neighbors : [ pet skate job freedom education ]
ai	neighbors : [ cat blonde job key language ]
colorblind	neighbors : [ horse rent watch difference college ]
coz	neighbors : [ kid asian country mind doctor ]
ice	neighbors : [ eat skate watch activity language ]
natural	neighbors : [ horse adult life difference language ]
friendly	neighbors : [ pet downtown job surgeon education ]
invest	neighbors : [ cat cheer job key poet ]
gourmet	neighbors : [ horse foodie job dessert painter ]
tailgate	neighbors : [ cat ahahah movie dollar language ]
vh[num]	neighbors : [ horse youtube job finance language ]
impression	neighbors : [ dog dragon movie impression student ]
sometime	neighbors : [ cat france job change language ]
stair	neighbors : [ dog youth car allergic roommate ]
middle	neighbors : [ eat rap job mind language ]
pc	neighbors : [ horse horror job pound library ]
chew	neighbors : [ pet color experience gum sport ]
definitely	neighbors : [ cat comedy job war college ]
wisdom	neighbors : [ horse youth job personality language ]
staff	neighbors : [ dog chat job machine language ]
alternative	neighbors : [ pet nerd job diet teacher ]
muse	neighbors : [ pet mouse job feeling poetry ]
crude	neighbors : [ horse rap job reward language ]
quiet	neighbors : [ dog chat job free language ]
tiny	neighbors : [ dog bitcoin movie personality teacher ]
charge	neighbors : [ pet dope movie secret architect ]
british	neighbors : [ animal google job culture language ]
flight	neighbors : [ animal miami job trouble college ]
david	neighbors : [ dog ufc movie workout language ]
breath	neighbors : [ horse blonde job breath cousin ]
decent	neighbors : [ pet solo movie sense language ]
paste	neighbors : [ cat football film dancer student ]
our	neighbors : [ animal youtube job pain college ]
weapon	neighbors : [ pet britney movie key language ]
nonsense	neighbors : [ horse skydive job recover language ]
drone	neighbors : [ animal skate movie government romance ]
techno	neighbors : [ job dance job body poetry ]
combination	neighbors : [ collar kindergarten experience suggestion aunt ]
feed	neighbors : [ horse youth job gas college ]
regret	neighbors : [ dog youtube job addiction architect ]
picky	neighbors : [ toy horror movie energy student ]
hobbie	neighbors : [ dog wan watch reality painter ]
recovery	neighbors : [ pet [num] job therapy language ]
also	neighbors : [ animal youtube watch patient student ]
tasty	neighbors : [ dog cheerleader movie machine student ]
american	neighbors : [ dog rap job cancer language ]
record	neighbors : [ cat studio movie involve student ]
stirling	neighbors : [ cat lindsey watch lindsey college ]
discovery	neighbors : [ animal perk watch discovery engineering ]
professional	neighbors : [ pet death job war library ]
freshman	neighbors : [ pet rap movie finance college ]
outside	neighbors : [ pet youtube job pain teacher ]
india	neighbors : [ animal portland job meditation language ]
shar	neighbors : [ cat skydive bet magic education ]
favourite	neighbors : [ toy housewife movie mind college ]
mater	neighbors : [ dog [num] job grade campus ]
reapply	neighbors : [ cat youth movie change college ]
away	neighbors : [ cat europe job war teacher ]
annoying	neighbors : [ pet mad watch mind doctor ]
smoking	neighbors : [ dog smoke job lifestyle history ]
proofread	neighbors : [ cat football job cancer organize ]
qualification	neighbors : [ rock europe job understand language ]
ethnic	neighbors : [ pet football movie sugar america ]
foreign	neighbors : [ dog [num] movie chemistry language ]
firefighter	neighbors : [ horse rap job alcohol profession ]
cursive	neighbors : [ eat skateboard movie chemistry poetry ]
pecan	neighbors : [ dog dentist film flavor poetry ]
respond	neighbors : [ pet chat job role language ]
modern	neighbors : [ animal hip job sort poetry ]
childrens	neighbors : [ cat youth job income language ]
ufc	neighbors : [ horse cop job workout fiction ]
scrub	neighbors : [ pet comic job war language ]
mom	neighbors : [ pet youth movie alcohol teacher ]
neoliberalism	neighbors : [ cat spare job reason teacher ]
gain	neighbors : [ pet cheer job medication architect ]
multiple	neighbors : [ pet bitcoin movie any college ]
battlestar	neighbors : [ tiki chat job protein education ]
part	neighbors : [ pet spain movie cancer poetry ]
message	neighbors : [ joke dragon job culture language ]
popular	neighbors : [ dog bitcoin watch war college ]
apologize	neighbors : [ cat chat job vitamin language ]
those	neighbors : [ pet bitcoin movie addiction college ]
buddhist	neighbors : [ kid smoke movie career father ]
greeting	neighbors : [ horse skateboard movie bank language ]
jim	neighbors : [ dog skate movie credit credit ]
loyal	neighbors : [ pet chat watch generation architect ]
ever	neighbors : [ dog lab job nature poetry ]
fluff	neighbors : [ pet rap job doctor poetry ]
promote	neighbors : [ horse shelter job pain poetry ]
lutefisk	neighbors : [ camera skate watch type language ]
surround	neighbors : [ cat skate job ocd poetry ]
stupid	neighbors : [ animal chat job body language ]
crush	neighbors : [ cat makeup movie club college ]
samantha	neighbors : [ dog horror movie role language ]
pastry	neighbors : [ eat dentist film condition language ]
tap	neighbors : [ pet dancer job artistic language ]
cry	neighbors : [ dog youtube job key language ]
their	neighbors : [ animal dancer movie addiction architect ]
hehe	neighbors : [ artist italy movie focus language ]
gut	neighbors : [ eat youtube job cancer language ]
criminal	neighbors : [ animal crime movie ability career ]
motivation	neighbors : [ dog skateboard job war language ]
oct	neighbors : [ puppy europe movie culture language ]
speckle	neighbors : [ cat dance film reason dorm ]
fifteen	neighbors : [ cat posse job chemistry college ]
lately	neighbors : [ cat chat job condition college ]
outerwear	neighbors : [ toy skateboard alabama choice doctor ]
heighten	neighbors : [ toy to movie rid language ]
depend	neighbors : [ pet perk job major architect ]
dressing	neighbors : [ horse youtube job sense student ]
bored	neighbors : [ eat chat movie happiness college ]
electric	neighbors : [ pet dance job medicine language ]
ex	neighbors : [ language chat job cancer language ]
ordinary	neighbors : [ pet rap movie body language ]
cheat	neighbors : [ retriever bff movie mind student ]
load	neighbors : [ animal comedy movie carbs library ]
blah	neighbors : [ cat skydive movie sense language ]
aspire	neighbors : [ cat youth job power language ]
encouragement	neighbors : [ cat cheerleader job condition language ]
own	neighbors : [ cat europe job addiction poetry ]
mount	neighbors : [ pet ahahah movie lactose language ]
feisty	neighbors : [ pet georgia watch finance librarian ]
gaga	neighbors : [ job gaga job role language ]
score	neighbors : [ animal horror movie would language ]
repossess	neighbors : [ pet youtube picture machine college ]
overweight	neighbors : [ pet girlfriend movie health college ]
messy	neighbors : [ toy youth movie lesson college ]
android	neighbors : [ eat android job retirement language ]
sip	neighbors : [ food youtube job truth student ]
boys	neighbors : [ horse metallica movie pain college ]
ginger	neighbors : [ toy blonde film flavor student ]
appreciate	neighbors : [ dog chat job condition college ]
require	neighbors : [ pet cheer job stress college ]
mraz	neighbors : [ cat clown job language language ]
excited	neighbors : [ cat chat job cancer college ]
sweden	neighbors : [ kid rap job key poetry ]
barbie	neighbors : [ dog fantasticccc watch sort student ]
barely	neighbors : [ cat spain movie mind college ]
gandalf	neighbors : [ horse dirty movie finance intern ]
trooper	neighbors : [ dog nyc job shift psychology ]
hairdresser	neighbors : [ eat youtube job sense painter ]
lovely	neighbors : [ animal skydive job key college ]
original	neighbors : [ cat a job trade student ]
hilarious	neighbors : [ toy youtube watch mind language ]
trimmed	neighbors : [ pet adult job retirement teacher ]
pouch	neighbors : [ pet dentist movie language language ]
urban	neighbors : [ cat skateboard job type poetry ]
chanel	neighbors : [ pet posse watch sort college ]
century	neighbors : [ cat google watch society chocolate ]
actually	neighbors : [ animal spain job account college ]
puerto	neighbors : [ horse rap job united language ]
podcast	neighbors : [ dog youtube job pain scholarship ]
call	neighbors : [ pet dance movie machine language ]
tanzania	neighbors : [ horse vera job volunteer language ]
link	neighbors : [ horse youtube film org student ]
classical	neighbors : [ cat christian job mind poetry ]
zoom	neighbors : [ job be movie heat talent ]
smarter	neighbors : [ pet spain job mind language ]
heartbreaking	neighbors : [ cat youtube job personality language ]
ho	neighbors : [ horse youtube job cancer student ]
risk	neighbors : [ dog spain job war language ]
chase	neighbors : [ toy adult job machine psychology ]
anywhere	neighbors : [ pet horror job machine student ]
geocaching	neighbors : [ kid skateboard job key poetry ]
mcqueen	neighbors : [ toy posse movie question poetry ]
multi	neighbors : [ animal [num] job key language ]
absolute	neighbors : [ dog downtown job rid language ]
surfer	neighbors : [ dog code movie addiction language ]
vegannnnn	neighbors : [ dog snowboard job generation library ]
full	neighbors : [ horse girlfriend job sort language ]
since	neighbors : [ cat spain job power college ]
twirl	neighbors : [ animal cheerleader movie avoid poetry ]
enjoyable	neighbors : [ bet spain job flavor bass ]
gaming	neighbors : [ pet waitress movie pill college ]
starve	neighbors : [ cat chat job retirement teacher ]
competitive	neighbors : [ pet dancer job war publishing ]
mail	neighbors : [ horse sucker job package library ]
culinary	neighbors : [ dog metallica job bank language ]
sweat	neighbors : [ pet youth job cancer college ]
specialize	neighbors : [ dog diego movie starve language ]
pitch	neighbors : [ horse italy job would practice ]
successful	neighbors : [ dog dancer movie stock publishing ]
soundcloud	neighbors : [ pet adult job stress library ]
edge	neighbors : [ animal chat job mind therapist ]
raw	neighbors : [ pet nerd job body college ]
factor	neighbors : [ dog chat movie mind poetry ]
signing	neighbors : [ dog chat movie vitamin language ]
near	neighbors : [ pet chicago film machine language ]
adam	neighbors : [ horse divorce movie machine language ]
pushy	neighbors : [ dog skydive job control student ]
bit	neighbors : [ animal comic movie mind language ]
ideal	neighbors : [ toy youth job sense library ]
pomeranian	neighbors : [ dog hop film reality father ]
probably	neighbors : [ animal spain job power college ]
asian	neighbors : [ animal sex movie machine language ]
seven	neighbors : [ cat bitcoin job chemistry teacher ]
historical	neighbors : [ horse crime job mind library ]
creme	neighbors : [ dog georgia movie flavor language ]
central	neighbors : [ dog spain job bank language ]
bradley	neighbors : [ pet blonde movie sort language ]
throw	neighbors : [ toy germany job mind poetry ]
someday	neighbors : [ dog death job machine college ]
wasn	neighbors : [ kid chat job generation college ]
brandon	neighbors : [ animal comedy movie therapy language ]
baybeees	neighbors : [ dog [num] job generation student ]
solar	neighbors : [ pet eclipse job rid teacher ]
cartographer	neighbors : [ dog cali job oil profession ]
kidnap	neighbors : [ dog kid movie heart college ]
nothing	neighbors : [ horse youtube job cancer poetry ]
put	neighbors : [ cat fam job addiction poetry ]
fortune	neighbors : [ dog youth job war college ]
mo	neighbors : [ pet youtube movie lesson language ]
bossy	neighbors : [ toy nickname job cancer student ]
beadwork	neighbors : [ pet bentley movie surgeon poetry ]
tip	neighbors : [ dog chat job sense student ]
graphic	neighbors : [ animal death job condition poetry ]
irvine	neighbors : [ animal med movie role psychology ]
heavy	neighbors : [ pet nerd movie machine college ]
homeschooled	neighbors : [ cat bitcoin movie power college ]
excitement	neighbors : [ horse youth job condition language ]
personal	neighbors : [ toy blonde job generation painter ]
distribute	neighbors : [ cat double job future biography ]
stinky	neighbors : [ pet youth job alcohol teacher ]
each	neighbors : [ pet buddhist movie dollar language ]
humble	neighbors : [ pet rap movie focus language ]
fanboy	neighbors : [ lasagna lasagna movie sense writer ]
hardly	neighbors : [ cat youtube job truth poetry ]
estas	neighbors : [ language teenager job key teacher ]
conscious	neighbors : [ horse youth job cancer college ]
plus	neighbors : [ dog death job condition language ]
finally	neighbors : [ cat chat job machine college ]
expert	neighbors : [ pet funny movie condition student ]
increase	neighbors : [ horse skydive job model language ]
shed	neighbors : [ horse youtube job poetry teacher ]
case	neighbors : [ dog gal movie sort student ]
two	neighbors : [ cat vampire job chemistry college ]
alot	neighbors : [ kid chat movie generation language ]
another	neighbors : [ dog bitcoin job dollar college ]
amazing	neighbors : [ dog dentist job machine language ]
[num]th	neighbors : [ dog paris film personality language ]
medical	neighbors : [ horse chat job weakness language ]
whoopee	neighbors : [ pet youtube movie sing language ]
meataholic	neighbors : [ dog chat job smoking language ]
sometimes	neighbors : [ animal youtube job addiction poetry ]
alos	neighbors : [ dog death watch stress student ]
main	neighbors : [ dog makeup movie sense student ]
renee	neighbors : [ dog sheeran movie surgeon teacher ]
cheapness	neighbors : [ dog chat job war education ]
woof	neighbors : [ horse cuba job role scholarship ]
resolve	neighbors : [ pet youtube job weakness architect ]
high	neighbors : [ dog bitcoin job power college ]
adventurous	neighbors : [ horse hip movie cancer language ]
pursuit	neighbors : [ horse goal job goal psychology ]
puck	neighbors : [ pet skate watch balance language ]
stream	neighbors : [ horse youth job chemistry language ]
texting	neighbors : [ cat chat job app language ]
shawarma	neighbors : [ eat youtube movie weakness seafood ]
leo	neighbors : [ pet dancer movie lesson language ]
grub	neighbors : [ pet chicago job usa college ]
twice	neighbors : [ cat miami job avoid language ]
grudge	neighbors : [ job youtube job tom education ]
thought	neighbors : [ pet horror job cancer poetry ]
petsmart	neighbors : [ pet youth job chemistry painter ]
scorpion	neighbors : [ horse skydive job fear kid ]
boondocks	neighbors : [ horse miami job retirement college ]
big	neighbors : [ dog skydive movie dollar poetry ]
guilty	neighbors : [ job cheerleader annoy ability store ]
leisure	neighbors : [ cat kid job free college ]
thousand	neighbors : [ cat blonde job machine library ]
anymore	neighbors : [ cat chat movie pill language ]
moving	neighbors : [ pet dancer job war language ]
understandable	neighbors : [ pet europe job personality language ]
pelican	neighbors : [ dog youth job medicine language ]
stun	neighbors : [ pet bus movie rid poet ]